text	label
Abbenzeller	Herkunft
Abramovski	Herkunft
Abramowski	Herkunft
Abramowsky	Herkunft
Abramski	Herkunft
Abramsky	Herkunft
Acar	Herkunft
Achberger	Herkunft
Achen	Herkunft
Achenbach	Herkunft
Achleitner	Herkunft
Achrainer	Herkunft
Acht	Herkunft
Achterberg	Herkunft
Adamczewska	Herkunft
Adamczewski	Herkunft
Adamovsky	Herkunft
Adamovskyy	Herkunft
Adamowska	Herkunft
Adamowski	Herkunft
Adamowsky	Herkunft
Adamschewski	Herkunft
Adamska	Herkunft
Adamske	Herkunft
Adamski	Herkunft
Adamskie	Herkunft
Adamsky	Herkunft
Adatepe	Herkunft
Adelsheimer	Herkunft
Adenau	Herkunft
Adenauer	Herkunft
Adeneuer	Herkunft
Adenäuer	Herkunft
Adiyaman	Herkunft
Adlberger	Herkunft
Adlkirchner	Herkunft
Adlkofer	Herkunft
Adomowski	Herkunft
Adorf	Herkunft
Adorff	Herkunft
Adscheid	Herkunft
Aegerter	Herkunft
Aevermann	Herkunft
Aevern	Herkunft
Agri	Herkunft
Ahl	Herkunft
Ahlhorn	Herkunft
Ahlschwede	Herkunft
Ahlschwedt	Herkunft
Ahlswe	Herkunft
Brodowsky	Herkunft
Brodska	Herkunft
Brodskaia	Herkunft
Brodskaja	Herkunft
Brodski	Herkunft
Brodskij	Herkunft
Brodskiy	Herkunft
Brodsky	Herkunft
Brodskyy	Herkunft
Broekhoven	Herkunft
Broich	Herkunft
Broicher	Herkunft
Brok	Herkunft
Brokhaus	Herkunft
Brokhausen	Herkunft
Brokhof	Herkunft
Brombach	Herkunft
Brombacher	Herkunft
Bromberg	Herkunft
Bromberger	Herkunft
Bronn	Herkunft
Broscheid	Herkunft
Brosowske	Herkunft
Brosowski	Herkunft
Brosowsky	Herkunft
Brotzeller	Herkunft
Brozowski	Herkunft
Brozowsky	Herkunft
Bruchhausen	Herkunft
Bruchhof	Herkunft
Bruchhoff	Herkunft
Bruchhöfer	Herkunft
Bruck	Herkunft
Brucke	Herkunft
Brucker	Herkunft
Bruckmoser	Herkunft
Bruckner	Herkunft
Brueck	Herkunft
Bruecker	Herkunft
Brueckmann	Herkunft
Brueckner	Herkunft
Bruenner	Herkunft
Bruggmoser	Herkunft
Brugmoser	Herkunft
Bruhne	Herkunft
Brukmoser	Herkunft
Brumbach	Herkunft
Brumbi	Herkunft
Brumby	Herkunft
Brummerhoff	Herkunft
Egloffstein	Herkunft
Eglofstein	Herkunft
Eglseder	Herkunft
Eglseer	Herkunft
Ehlscheid	Herkunft
Ehlscheidt	Herkunft
Ehrbächer	Herkunft
Ehrenberg	Herkunft
Ehrenberger	Herkunft
Ehrfurt	Herkunft
Ehrhorn	Herkunft
Ehrich	Herkunft
Ehricht	Herkunft
Ehrig	Herkunft
Ehrlacher	Herkunft
Eibach	Herkunft
Eich	Herkunft
Eichberg	Herkunft
Eichberger	Herkunft
Eichelhard	Herkunft
Eichelhardt	Herkunft
Eichelhart	Herkunft
Eichelsbacher	Herkunft
Eichelsdörfer	Herkunft
Eichen	Herkunft
Eichenauer	Herkunft
Eichenberg	Herkunft
Eichenberger	Herkunft
Eichendorf	Herkunft
Eichendorff	Herkunft
Eichenseer	Herkunft
Eichenseher	Herkunft
Eicher	Herkunft
Eichholdtz	Herkunft
Eichholtz	Herkunft
Eichholtzer	Herkunft
Eichholz	Herkunft
Eichholzer	Herkunft
Eichhorst	Herkunft
Eichinger	Herkunft
Eichmann	Herkunft
Eicholtz	Herkunft
Eicholz	Herkunft
Eicholzer	Herkunft
Eichorst	Herkunft
Eichstetter	Herkunft
Eichstätter	Herkunft
Eichwald	Herkunft
Eichwalder	Herkunft
Eichwaldt	Herkunft
Guggenbühler	Herkunft
Guggenmoos	Herkunft
Guggenmos	Herkunft
Guggenmoser	Herkunft
Guggomos	Herkunft
Guggumos	Herkunft
Gummersbach	Herkunft
Gural	Herkunft
Guralczyk	Herkunft
Guralzik	Herkunft
Gurol	Herkunft
Guroll	Herkunft
Gurska	Herkunft
Gurske	Herkunft
Gurski	Herkunft
Gurskij	Herkunft
Gursky	Herkunft
Gutschendies	Herkunft
Gutzentat	Herkunft
Gymnich	Herkunft
Gäbler	Herkunft
Göhring	Herkunft
Gökce	Herkunft
Gökcek	Herkunft
Göktepe	Herkunft
Gönnheimer	Herkunft
Göppinger	Herkunft
Göring	Herkunft
Görlinger	Herkunft
Görlitz	Herkunft
Görlitzer	Herkunft
Görmar	Herkunft
Görmer	Herkunft
Görner	Herkunft
Görsdorf	Herkunft
Götzger	Herkunft
Götzinger	Herkunft
Güllstorf	Herkunft
Gülsdorf	Herkunft
Gülsdorff	Herkunft
Gülstorf	Herkunft
Gülstorff	Herkunft
Gülstorp	Herkunft
Gültepe	Herkunft
Güneyli	Herkunft
Günzkofer	Herkunft
Gürcü	Herkunft
Haag	Herkunft
Haager	Herkunft
Haagmann	Herkunft
Jasansky	Herkunft
Jaschensky	Herkunft
Jaschinski	Herkunft
Jaschinsky	Herkunft
Jasenski	Herkunft
Jasensky	Herkunft
Jasienski	Herkunft
Jasinska	Herkunft
Jasinski	Herkunft
Jasinsky	Herkunft
Jasmund	Herkunft
Jastczemski	Herkunft
Jastrebski	Herkunft
Jastrembski	Herkunft
Jastremski	Herkunft
Jastremsky	Herkunft
Jastrimski	Herkunft
Jastrzebska	Herkunft
Jastrzebski	Herkunft
Jastrzembski	Herkunft
Jastrzembskis	Herkunft
Jastrzembsky	Herkunft
Jastrzemski	Herkunft
Jastrzemsky	Herkunft
Jastrzimski	Herkunft
Jastschemski	Herkunft
Jastzembski	Herkunft
Jaszinski	Herkunft
Jaszinsky	Herkunft
Javorski	Herkunft
Javorsky	Herkunft
Jaworska	Herkunft
Jaworski	Herkunft
Jaworsky	Herkunft
Jazinski	Herkunft
Jeblonski	Herkunft
Jeblonsky	Herkunft
Jedamowski	Herkunft
Jedamske	Herkunft
Jedamski	Herkunft
Jedamsky	Herkunft
Jeddeloh	Herkunft
Jedlitzky	Herkunft
Jesberg	Herkunft
Jeschinski	Herkunft
Jeschinsky	Herkunft
Jestczemski	Herkunft
Jestrembski	Herkunft
Jestremski	Herkunft
Jestrimski	Herkunft
Leithe	Herkunft
Leithner	Herkunft
Leiting	Herkunft
Leitner	Herkunft
Leißner	Herkunft
Lembeck	Herkunft
Lemberg	Herkunft
Lemberger	Herkunft
Lemmes	Herkunft
Lengefeld	Herkunft
Lengefeldt	Herkunft
Lengenfelder	Herkunft
Lengfellner	Herkunft
Lengkeit	Herkunft
Lenkait	Herkunft
Lenkaitis	Herkunft
Lenkajtis	Herkunft
Lenkeit	Herkunft
Lenkheit	Herkunft
Leschensky	Herkunft
Leschinski	Herkunft
Leschinsky	Herkunft
Leschner	Herkunft
Leschynski	Herkunft
Leschzenski	Herkunft
Leschzensky	Herkunft
Leschzinski	Herkunft
Leschzinsky	Herkunft
Lescinskas	Herkunft
Lescinski	Herkunft
Lescinsky	Herkunft
Lesczenski	Herkunft
Lesczensky	Herkunft
Lesczinski	Herkunft
Lesczynski	Herkunft
Lesinskas	Herkunft
Lessenich	Herkunft
Lesszinsky	Herkunft
Leszcynski	Herkunft
Leszczenski	Herkunft
Leszczensky	Herkunft
Leszczinski	Herkunft
Leszczynska	Herkunft
Leszczynski	Herkunft
Leszinski	Herkunft
Leszinsky	Herkunft
Leszynski	Herkunft
Leszynsky	Herkunft
Lettau	Herkunft
Leupolz	Herkunft
Nettesheim	Herkunft
Netzband	Herkunft
Netzbandt	Herkunft
Netzeband	Herkunft
Netzebandt	Herkunft
Neubacher	Herkunft
Neudeck	Herkunft
Neudecker	Herkunft
Neudegger	Herkunft
Neudoerfer	Herkunft
Neudorf	Herkunft
Neudorfer	Herkunft
Neudorff	Herkunft
Neudörfer	Herkunft
Neudörffer	Herkunft
Neuendorf	Herkunft
Neuendorff	Herkunft
Neuenhagen	Herkunft
Neuenhaus	Herkunft
Neuenhausen	Herkunft
Neuenhofen	Herkunft
Neuenhofer	Herkunft
Neuenhöfer	Herkunft
Neuenkirch	Herkunft
Neuenkirchen	Herkunft
Neuerburg	Herkunft
Neufanger	Herkunft
Neufelder	Herkunft
Neuffer	Herkunft
Neuhaeusler	Herkunft
Neuhaus	Herkunft
Neuhausen	Herkunft
Neuhauser	Herkunft
Neuhauss	Herkunft
Neuhauß	Herkunft
Neuhaußer	Herkunft
Neuheiser	Herkunft
Neuheuser	Herkunft
Neuhoefer	Herkunft
Neuhof	Herkunft
Neuhofer	Herkunft
Neuhs	Herkunft
Neuhäuser	Herkunft
Neuhäusler	Herkunft
Neuhäusser	Herkunft
Neuhäußer	Herkunft
Neuhäußler	Herkunft
Neuhöfer	Herkunft
Neukirch	Herkunft
Neukirchen	Herkunft
Pöhle	Herkunft
Pöhler	Herkunft
Pöhlert	Herkunft
Pöhlmann	Herkunft
Pöhm	Herkunft
Pölmann	Herkunft
Pöppinghaus	Herkunft
Pöttinger	Herkunft
Pühl	Herkunft
Pühler	Herkunft
Pühlhofer	Herkunft
Pühlhöfer	Herkunft
Pühringer	Herkunft
Püringer	Herkunft
Pürkner	Herkunft
Pützfeld	Herkunft
Pützstück	Herkunft
Quasdorf	Herkunft
Quasdorff	Herkunft
Quedenau	Herkunft
Quednau	Herkunft
Quednow	Herkunft
Quelle	Herkunft
Quellen	Herkunft
Quellhorst	Herkunft
Quiadkowsky	Herkunft
Quiatkowski	Herkunft
Quiatkowsky	Herkunft
Quint	Herkunft
Quosdorf	Herkunft
Quädnau	Herkunft
Rabenhorst	Herkunft
Rabenstein	Herkunft
Rabensteiner	Herkunft
Radensleben	Herkunft
Rafeiner	Herkunft
Raffeiner	Herkunft
Raffelsberger	Herkunft
Raffl	Herkunft
Rafflenbeul	Herkunft
Rahmelow	Herkunft
Rahmlow	Herkunft
Rahmstorf	Herkunft
Rahmstorff	Herkunft
Raimann	Herkunft
Rakus	Herkunft
Rambow	Herkunft
Ramelow	Herkunft
Ramlow	Herkunft
Rammrath	Herkunft
Aach	Wohnstätte
Aal	Wohnstätte
Aandekerk	Wohnstätte
Abbühl	Wohnstätte
Ablas	Wohnstätte
Ablass	Wohnstätte
Ablasser	Wohnstätte
Ablaß	Wohnstätte
Ach	Wohnstätte
Ache	Wohnstätte
Acher	Wohnstätte
Achhorner	Wohnstätte
Achleitner	Wohnstätte
Achler	Wohnstätte
Achmann	Wohnstätte
Achner	Wohnstätte
Achorner	Wohnstätte
Achten	Wohnstätte
Achterberg	Wohnstätte
Achteresch	Wohnstätte
Achterfeld	Wohnstätte
Achterfeldt	Wohnstätte
Achterhoff	Wohnstätte
Achterhold	Wohnstätte
Achterholt	Wohnstätte
Achterhuis	Wohnstätte
Achterkamp	Wohnstätte
Achterkerke	Wohnstätte
Achterkirche	Wohnstätte
Achterkirchen	Wohnstätte
Achtermann	Wohnstätte
Achternbosch	Wohnstätte
Achternkamp	Wohnstätte
Achthaler	Wohnstätte
Acker	Wohnstätte
Ackeren	Wohnstätte
Ackerl	Wohnstätte
Ackern	Wohnstätte
Ackers	Wohnstätte
Ackert	Wohnstätte
Ada	Wohnstätte
Adali	Wohnstätte
Adatepe	Wohnstätte
Adeler	Wohnstätte
Adler	Wohnstätte
Aengen-Eyndt	Wohnstätte
Aengenendt	Wohnstätte
Aengeneyndt	Wohnstätte
Aengenheister	Wohnstätte
Aengenheyster	Wohnstätte
Böckl	Wohnstätte
Böckmann	Wohnstätte
Böger	Wohnstätte
Böhl	Wohnstätte
Böhle	Wohnstätte
Böhler	Wohnstätte
Böhmcke	Wohnstätte
Böhmcker	Wohnstätte
Böhmecke	Wohnstätte
Böhmeke	Wohnstätte
Böhmke	Wohnstätte
Böhmken	Wohnstätte
Böhmker	Wohnstätte
Böhne	Wohnstätte
Böhnemann	Wohnstätte
Bökamp	Wohnstätte
Böke	Wohnstätte
Bökenbrink	Wohnstätte
Bökenheide	Wohnstätte
Bökenkamp	Wohnstätte
Bökenkötter	Wohnstätte
Böker	Wohnstätte
Bökers	Wohnstätte
Bökmann	Wohnstätte
Böll	Wohnstätte
Bömcke	Wohnstätte
Bömecke	Wohnstätte
Bömeke	Wohnstätte
Bömke	Wohnstätte
Bömken	Wohnstätte
Bömker	Wohnstätte
Bömkes	Wohnstätte
Bönemann	Wohnstätte
Bönhoff	Wohnstätte
Börner	Wohnstätte
Börnert	Wohnstätte
Bösefeld	Wohnstätte
Bösefeldt	Wohnstätte
Bösveld	Wohnstätte
Büch	Wohnstätte
Büche	Wohnstätte
Büchel	Wohnstätte
Büchele	Wohnstätte
Bücheler	Wohnstätte
Büchelin	Wohnstätte
Büchen	Wohnstätte
Bücher	Wohnstätte
Büchl	Wohnstätte
Büchle	Wohnstätte
Büchlein	Wohnstätte
Griebl	Wohnstätte
Grieble	Wohnstätte
Griebler	Wohnstätte
Griebling	Wohnstätte
Grieblinger	Wohnstätte
Griebner	Wohnstätte
Griensteidl	Wohnstätte
Griep	Wohnstätte
Griepp	Wohnstätte
Gries	Wohnstätte
Griesfelder	Wohnstätte
Griesfeller	Wohnstätte
Grieskamp	Wohnstätte
Grießkamp	Wohnstätte
Grinbergs	Wohnstätte
Gripp	Wohnstätte
Grobe	Wohnstätte
Groeber	Wohnstätte
Groehn	Wohnstätte
Groen	Wohnstätte
Groene	Wohnstätte
Groenebaum	Wohnstätte
Groenefeld	Wohnstätte
Groenegraes	Wohnstätte
Groenegreß	Wohnstätte
Groenen	Wohnstätte
Groenendaal	Wohnstätte
Groenendal	Wohnstätte
Groenenveld	Wohnstätte
Groenenwald	Wohnstätte
Groener	Wohnstätte
Groeneveld	Wohnstätte
Groenevelt	Wohnstätte
Groeneweg	Wohnstätte
Groenewegen	Wohnstätte
Groenfeld	Wohnstätte
Groenfeldt	Wohnstätte
Groenhagen	Wohnstätte
Groenhof	Wohnstätte
Groenhoff	Wohnstätte
Groenveld	Wohnstätte
Groenwald	Wohnstätte
Grohn	Wohnstätte
Grohne	Wohnstätte
Grohner	Wohnstätte
Grohnfeldt	Wohnstätte
Grohnwald	Wohnstätte
Grohnwaldt	Wohnstätte
Grohskreutz	Wohnstätte
Grois	Wohnstätte
Holzkamp	Wohnstätte
Holzkamper	Wohnstätte
Holzkampf	Wohnstätte
Holzkemper	Wohnstätte
Holzkämper	Wohnstätte
Holzkämpfer	Wohnstätte
Holzkötter	Wohnstätte
Holzleithner	Wohnstätte
Holzleitner	Wohnstätte
Holzman	Wohnstätte
Holzmann	Wohnstätte
Holzmanns	Wohnstätte
Holzner	Wohnstätte
Holzweg	Wohnstätte
Holzweger	Wohnstätte
Homann	Wohnstätte
Honacker	Wohnstätte
Honigbaum	Wohnstätte
Honnacker	Wohnstätte
Hooffacker	Wohnstätte
Hoogestraat	Wohnstätte
Hoogstraat	Wohnstätte
Hoop	Wohnstätte
Hooper	Wohnstätte
Hoopmann	Wohnstätte
Hoops	Wohnstätte
Hoos	Wohnstätte
Hope	Wohnstätte
Hopen	Wohnstätte
Hopfengart	Wohnstätte
Hopfengärtner	Wohnstätte
Hopfenheit	Wohnstätte
Hopfgart	Wohnstätte
Hopfgarten	Wohnstätte
Hoping	Wohnstätte
Hopmann	Wohnstätte
Hoppegarten	Wohnstätte
Hoppenbrink	Wohnstätte
Hoppenbrock	Wohnstätte
Hoppenheidt	Wohnstätte
Hoppenheit	Wohnstätte
Hoppenkamp	Wohnstätte
Hoppenkamps	Wohnstätte
Hoppenkams	Wohnstätte
Hoppenworth	Wohnstätte
Hoppmann	Wohnstätte
Hoppmanns	Wohnstätte
Horacek	Wohnstätte
Horack	Wohnstätte
Horak	Wohnstätte
Kroon	Wohnstätte
Kroonen	Wohnstätte
Kruhming	Wohnstätte
Krumenacker	Wohnstätte
Krumin	Wohnstätte
Kruming	Wohnstätte
Krumins	Wohnstätte
Kruminsch	Wohnstätte
Krumm	Wohnstätte
Krummacker	Wohnstätte
Krummenacker	Wohnstätte
Krummnack	Wohnstätte
Krummnacker	Wohnstätte
Krumnack	Wohnstätte
Krumnacke	Wohnstätte
Krumnacker	Wohnstätte
Kruthof	Wohnstätte
Kruthoff	Wohnstätte
Kräbs	Wohnstätte
Krähenbühl	Wohnstätte
Kröhner	Wohnstätte
Krömer	Wohnstätte
Krönchen	Wohnstätte
Kröner	Wohnstätte
Krönlein	Wohnstätte
Kuberg	Wohnstätte
Kuehberger	Wohnstätte
Kuehlewind	Wohnstätte
Kuehnast	Wohnstätte
Kuhberg	Wohnstätte
Kuhberger	Wohnstätte
Kuhl	Wohnstätte
Kuhle	Wohnstätte
Kuhlemann	Wohnstätte
Kuhlenkamp	Wohnstätte
Kuhlenkampff	Wohnstätte
Kuhlenkemper	Wohnstätte
Kuhlenkötter	Wohnstätte
Kuhlewind	Wohnstätte
Kuhljürgen	Wohnstätte
Kuhlkamp	Wohnstätte
Kuhlmann	Wohnstätte
Kuijl	Wohnstätte
Kuil	Wohnstätte
Kulenkamff	Wohnstätte
Kulenkamp	Wohnstätte
Kulenkampf	Wohnstätte
Kulenkampff	Wohnstätte
Kull	Wohnstätte
Kulle	Wohnstätte
Niestradt	Wohnstätte
Niestrat	Wohnstätte
Niestrate	Wohnstätte
Niestrath	Wohnstätte
Nieweg	Wohnstätte
Nieße	Wohnstätte
Niggebruegge	Wohnstätte
Niggebrügge	Wohnstätte
Niggehoff	Wohnstätte
Niggeloh	Wohnstätte
Niggeweg	Wohnstätte
Nijhof	Wohnstätte
Nijhoff	Wohnstätte
Nijland	Wohnstätte
Nijlant	Wohnstätte
Nikel	Wohnstätte
Nikkel	Wohnstätte
Niland	Wohnstätte
Nobes	Wohnstätte
Nobis	Wohnstätte
Noeckel	Wohnstätte
Noll	Wohnstätte
Nonnengess	Wohnstätte
Nonnengeß	Wohnstätte
Nonnengässer	Wohnstätte
Nonnengäßer	Wohnstätte
Noordkamp	Wohnstätte
Noordmann	Wohnstätte
Nootenboom	Wohnstätte
Nord	Wohnstätte
Nordbrink	Wohnstätte
Nordbrock	Wohnstätte
Nordbroek	Wohnstätte
Nordbruch	Wohnstätte
Norde	Wohnstätte
Nordemann	Wohnstätte
Norden	Wohnstätte
Nordenholt	Wohnstätte
Nordenholz	Wohnstätte
Norder	Wohnstätte
Nordhoff	Wohnstätte
Nordhold	Wohnstätte
Nordholt	Wohnstätte
Nordholtz	Wohnstätte
Nordholz	Wohnstätte
Nordkamp	Wohnstätte
Nordkämper	Wohnstätte
Nordloh	Wohnstätte
Nordmann	Wohnstätte
Nordsieck	Wohnstätte
Schlehlein	Wohnstätte
Schlehmann	Wohnstätte
Schlehofer	Wohnstätte
Schlehöfer	Wohnstätte
Schleich	Wohnstätte
Schleicher	Wohnstätte
Schleicherdt	Wohnstätte
Schleichert	Wohnstätte
Schleichhardt	Wohnstätte
Schleif	Wohnstätte
Schleife	Wohnstätte
Schleiff	Wohnstätte
Schleifmann	Wohnstätte
Schleipfer	Wohnstätte
Schleipfner	Wohnstätte
Schlele	Wohnstätte
Schlelein	Wohnstätte
Schlemann	Wohnstätte
Schlich	Wohnstätte
Schlicher	Wohnstätte
Schlichert	Wohnstätte
Schlicht	Wohnstätte
Schlichte	Wohnstätte
Schlichter	Wohnstätte
Schlichtmann	Wohnstätte
Schlick	Wohnstätte
Schlicker	Wohnstätte
Schlickers	Wohnstätte
Schlickert	Wohnstätte
Schlickhoff	Wohnstätte
Schlickmann	Wohnstätte
Schlieck	Wohnstätte
Schliecker	Wohnstätte
Schlieckmann	Wohnstätte
Schliek	Wohnstätte
Schlieker	Wohnstätte
Schliekermann	Wohnstätte
Schliekert	Wohnstätte
Schliekmann	Wohnstätte
Schlieperskötter	Wohnstätte
Schlik	Wohnstätte
Schlikker	Wohnstätte
Schlipf	Wohnstätte
Schlipkoeter	Wohnstätte
Schlipköter	Wohnstätte
Schlipköther	Wohnstätte
Schlipper	Wohnstätte
Schlitz	Wohnstätte
Schlitzer	Wohnstätte
Schlobohm	Wohnstätte
Timmerhoff	Wohnstätte
Timmerhues	Wohnstätte
Timmerhuis	Wohnstätte
Timmerkamp	Wohnstätte
Timmerscheidt	Wohnstätte
Timpe	Wohnstätte
Timpenfeld	Wohnstätte
Timphaus	Wohnstätte
Timphus	Wohnstätte
Tinnemann	Wohnstätte
Tippkoetter	Wohnstätte
Tippkötter	Wohnstätte
Tistel	Wohnstätte
Tistl	Wohnstätte
Tistler	Wohnstätte
Todam	Wohnstätte
Todamm	Wohnstätte
Toepfl	Wohnstätte
Toepp	Wohnstätte
Tohmfor	Wohnstätte
tom Felde	Wohnstätte
tom Wörden	Wohnstätte
Tombach	Wohnstätte
Tomberg	Wohnstätte
Tomberge	Wohnstätte
Tomberger	Wohnstätte
Tombergs	Wohnstätte
Tombrinck	Wohnstätte
Tombrink	Wohnstätte
Tombuelt	Wohnstätte
Tombusch	Wohnstätte
Tombült	Wohnstätte
Tomfeld	Wohnstätte
Tomfelde	Wohnstätte
Tomfohrde	Wohnstätte
Tomforde	Wohnstätte
Tomfort	Wohnstätte
Topf	Wohnstätte
Tophof	Wohnstätte
Tophoff	Wohnstätte
Topkaya	Wohnstätte
Topp	Wohnstätte
Topphoff	Wohnstätte
Torbeck	Wohnstätte
Torbecke	Wohnstätte
Torheiden	Wohnstätte
Torheyden	Wohnstätte
Torhorst	Wohnstätte
Tormählen	Wohnstätte
Tormöhlen	Wohnstätte
Abali	Übername
Abasiz	Übername
Abbott	Übername
Abbt	Übername
Abs	Übername
Abt	Übername
Abts	Übername
Acar	Übername
Acht	Übername
Achtel	Übername
Achter	Übername
Achtert	Übername
Achtmann	Übername
Achtner	Übername
Achtzehn	Übername
Achtzehner	Übername
Achtzehnter	Übername
Achtziger	Übername
Achziger	Übername
Acikelli	Übername
Acikgöz	Übername
Adebahr	Übername
Adebar	Übername
Adeler	Übername
Adil	Übername
Adiyaman	Übername
Adler	Übername
Adsiz	Übername
Advena	Übername
Aechter	Übername
Aechtner	Übername
Aelter	Übername
Aeltermann	Übername
Aestel	Übername
Afacan	Übername
Agca	Übername
Agirbas	Übername
Ahnesorg	Übername
Ahnsorge	Übername
Aichhorn	Übername
Aidam	Übername
Aigen	Übername
Aigenherr	Übername
Aigenmann	Übername
Aign	Übername
Aigner	Übername
Aignherr	Übername
Akbaba	Übername
Akbas	Übername
Akbiyik	Übername
Dreissigacker	Übername
Dreiwurst	Übername
Dreizehner	Übername
Dreizehnter	Übername
Dreizig	Übername
Dreißgacker	Übername
Dreißig	Übername
Dreißigacker	Übername
Drenker	Übername
Drenkers	Übername
Drenkert	Übername
Dreybrodt	Übername
Dreyheller	Übername
Dreyhsig	Übername
Dreyssig	Übername
Dreyssigacker	Übername
Dreyzehner	Übername
Dreyßig	Übername
Dreyßigacker	Übername
Drillhose	Übername
Drinkhut	Übername
Drinkhuth	Übername
Drinkuth	Übername
Droege	Übername
Droll	Übername
Drolle	Übername
Drollmann	Übername
Druckenbrod	Übername
Druckenbrodt	Übername
Dröge	Übername
Drüge	Übername
Dube	Übername
Dubenkrop	Übername
Dubenkropp	Übername
Duber	Übername
Dubert	Übername
Dubon	Übername
Duch	Übername
Duchet	Übername
Duda	Übername
Dudda	Übername
Dudde	Übername
Duddeck	Übername
Duddek	Übername
Dude	Übername
Dudeck	Übername
Dudek	Übername
Duechting	Übername
Duefel	Übername
Duehrkoop	Übername
Gräbing	Übername
Gräul	Übername
Gräulich	Übername
Gräuling	Übername
Gröber	Übername
Gröbert	Übername
Gröhn	Übername
Gröhne	Übername
Grön	Übername
Gröne	Übername
Grönemann	Übername
Gröner	Übername
Grönert	Übername
Grönig	Übername
Gröning	Übername
Grönn	Übername
Grössl	Übername
Grössle	Übername
Grösslein	Übername
Größl	Übername
Größle	Übername
Größlein	Übername
Grübler	Übername
Grühn	Übername
Grün	Übername
Grünaug	Übername
Grünaugl	Übername
Gründel	Übername
Gründl	Übername
Gründling	Übername
Grüne	Übername
Grünemann	Übername
Grüner	Übername
Grünerbel	Übername
Grünert	Übername
Grünhaupt	Übername
Grünhut	Übername
Grünig	Übername
Grüning	Übername
Grünitz	Übername
Grünler	Übername
Grünling	Übername
Grünlinger	Übername
Grünlings	Übername
Grünmann	Übername
Grünn	Übername
Grünrock	Übername
Grünspecht	Übername
Grünvogel	Übername
Grünärmel	Übername
Kleinlein	Übername
Kleinmann	Übername
Kleinmanns	Übername
Kleinschwager	Übername
Kleinsorg	Übername
Kleinsorge	Übername
Kleinsorgen	Übername
Kleinvogel	Übername
Kleisner	Übername
Kleissner	Übername
Kleißner	Übername
Klemm	Übername
Klemme	Übername
Klenk	Übername
Klepel	Übername
Klepl	Übername
Kleppel	Übername
Kleppl	Übername
Klespies	Übername
Kleu	Übername
Kleuel	Übername
Kleusener	Übername
Kleusner	Übername
Kleußner	Übername
Kleylein	Übername
Kliebenschedel	Übername
Klinckert	Übername
Klingeler	Übername
Klingelmann	Übername
Klingenfuss	Übername
Klingenfuß	Übername
Klingenspohr	Übername
Klingenspor	Übername
Klingfuss	Übername
Klingfuß	Übername
Klinghard	Übername
Klinghardt	Übername
Klinghart	Übername
Klingkert	Übername
Klingler	Übername
Klingshirn	Übername
Klingspohr	Übername
Klingspor	Übername
Klingsporn	Übername
Klinkerfuss	Übername
Klinkerfuß	Übername
Klinkert	Übername
Klinkertz	Übername
Klinkfuss	Übername
Klinkhard	Übername
Löbl	Übername
Löble	Übername
Löblein	Übername
Löbsack	Übername
Löck	Übername
Löckel	Übername
Löckelt	Übername
Löckle	Übername
Löcklin	Übername
Löckmann	Übername
Löhser	Übername
Lörch	Übername
Löscher	Übername
Löschhorn	Übername
Löschner	Übername
Löseke	Übername
Löseken	Übername
Lösel	Übername
Löser	Übername
Lösken	Übername
Lösl	Übername
Lösle	Übername
Löslein	Übername
Löss	Übername
Lössel	Übername
Lösser	Übername
Lössl	Übername
Lössle	Übername
Lösslein	Übername
Lösslin	Übername
Löw	Übername
Löwe	Übername
Löwel	Übername
Löwen	Übername
Löwenhaupt	Übername
Löwenherz	Übername
Löwenmuth	Übername
Löwlein	Übername
Lößel	Übername
Lößer	Übername
Lößl	Übername
Lößle	Übername
Lößlein	Übername
Lößlin	Übername
Lüdtschwager	Übername
Lütkefedder	Übername
Lütkemann	Übername
Lütkevedder	Übername
Lüttgemann	Übername
Lüttjemann	Übername
Pschorr	Übername
Pschribülla	Übername
Pschybilski	Übername
Ptacek	Übername
Ptach	Übername
Ptack	Übername
Ptaczek	Übername
Ptak	Übername
Ptascheck	Übername
Ptaschek	Übername
Ptaszek	Übername
Ptatscheck	Übername
Ptatschek	Übername
Ptock	Übername
Ptok	Übername
Ptoschek	Übername
Ptoszek	Übername
Pucala	Übername
Pucalla	Übername
Puce	Übername
Puff	Übername
Puffpaff	Übername
Pufpaff	Übername
Pumper	Übername
Pundsack	Übername
Pundschuh	Übername
Puntheller	Übername
Puntschuh	Übername
Puppe	Übername
Pusamssies	Übername
Pusamßies	Übername
Pusbatzkies	Übername
Pusbatzkis	Übername
Puschamsies	Übername
Puschies	Übername
Puscz	Übername
Puskepeleitis	Übername
Puskeppel	Übername
Puskeppeleit	Übername
Puskeppelies	Übername
Pussamsies	Übername
Puszamszies	Übername
Puszcz	Übername
Puszczewicz	Übername
Puszies	Übername
Putter	Übername
Putterlik	Übername
Putz	Übername
Putzalla	Übername
Putze	Übername
Schrickel	Übername
Schrimpf	Übername
Schroeck	Übername
Schroeckel	Übername
Schroetel	Übername
Schroetgens	Übername
Schroetke	Übername
Schroettle	Übername
Schrom	Übername
Schromm	Übername
Schrot	Übername
Schroth	Übername
Schrott	Übername
Schrumpf	Übername
Schräml	Übername
Schrämli	Übername
Schröck	Übername
Schröckel	Übername
Schröckhaas	Übername
Schrötel	Übername
Schrötgens	Übername
Schrötges	Übername
Schröthlin	Übername
Schrötke	Übername
Schrötl	Übername
Schrötle	Übername
Schrötlin	Übername
Schröttel	Übername
Schröttle	Übername
Schrümpf	Übername
Schu	Übername
Schuch	Übername
Schuck	Übername
Schuckert	Übername
Schuehle	Übername
Schuele	Übername
Schuelein	Übername
Schuettendiebel	Übername
Schuettloeffel	Übername
Schuettpelz	Übername
Schug	Übername
Schugk	Übername
Schuh	Übername
Schuhose	Übername
Schuk	Übername
Schukalla	Übername
Schukalski	Übername
Schukoff	Übername
Schukov	Übername
Schukow	Übername
Sürmeli	Übername
Süslü	Übername
Süss	Übername
Süssbier	Übername
Süssel	Übername
Süssemilch	Übername
Süssl	Übername
Süssle	Übername
Süsslin	Übername
Süssmann	Übername
Süssmilch	Übername
Süß	Übername
Süßbier	Übername
Süßel	Übername
Süßemilch	Übername
Süßl	Übername
Süßle	Übername
Süßlin	Übername
Süßmann	Übername
Süßmilch	Übername
Tack	Übername
Tacke	Übername
Taentzer	Übername
Taentzler	Übername
Taenzel	Übername
Taenzer	Übername
Taenzler	Übername
Taeubel	Übername
Taeuber	Übername
Taeubert	Übername
Taeubl	Übername
Taleb	Übername
Talebi	Übername
Talebian	Übername
Talebizadeh	Übername
Talib	Übername
Tandogan	Übername
Tantz	Übername
Tanz	Übername
Tanzeglock	Übername
Tanzeglocke	Übername
Tanzel	Übername
Tanzer	Übername
Tanzius	Übername
Tanzler	Übername
Tanzmann	Übername
Tapp	Übername
Tappe	Übername
Tappen	Übername
Tapper	Übername
Abay	Rufnamenmuster
Acikelli	Rufnamenmuster
Acikgöz	Rufnamenmuster
Ada	Rufnamenmuster
Adibelli	Rufnamenmuster
Adigüzel	Rufnamenmuster
Adil	Rufnamenmuster
Agac	Rufnamenmuster
Agirbas	Rufnamenmuster
Ak	Rufnamenmuster
Akalin	Rufnamenmuster
Akar	Rufnamenmuster
Akarcay	Rufnamenmuster
Akarsu	Rufnamenmuster
Akbaba	Rufnamenmuster
Akbalik	Rufnamenmuster
Akbas	Rufnamenmuster
Akcay	Rufnamenmuster
Akdag	Rufnamenmuster
Akdogan	Rufnamenmuster
Akilli	Rufnamenmuster
Akin	Rufnamenmuster
Akkus	Rufnamenmuster
Akman	Rufnamenmuster
Aktay	Rufnamenmuster
Akyüz	Rufnamenmuster
Al	Rufnamenmuster
Alaca	Rufnamenmuster
Alacali	Rufnamenmuster
Aladag	Rufnamenmuster
Aldirmaz	Rufnamenmuster
Algan	Rufnamenmuster
Alim	Rufnamenmuster
Alimoglu	Rufnamenmuster
Alkis	Rufnamenmuster
Alp	Rufnamenmuster
Altin	Rufnamenmuster
Altun	Rufnamenmuster
Anil	Rufnamenmuster
Apaydin	Rufnamenmuster
Arat	Rufnamenmuster
Ardic	Rufnamenmuster
Ari	Rufnamenmuster
Arikan	Rufnamenmuster
Arisoy	Rufnamenmuster
Armagan	Rufnamenmuster
Arslan	Rufnamenmuster
Arslanbas	Rufnamenmuster
Arslancan	Rufnamenmuster
Arslanoglu	Rufnamenmuster
Basar	Rufnamenmuster
Basaran	Rufnamenmuster
Basarir	Rufnamenmuster
Basegmez	Rufnamenmuster
Baskan	Rufnamenmuster
Basoglu	Rufnamenmuster
Basol	Rufnamenmuster
Bati	Rufnamenmuster
Batmaz	Rufnamenmuster
Battal	Rufnamenmuster
Batur	Rufnamenmuster
Bayar	Rufnamenmuster
Bayir	Rufnamenmuster
Baysal	Rufnamenmuster
Bedir	Rufnamenmuster
Bekdemir	Rufnamenmuster
Beker	Rufnamenmuster
Bektas	Rufnamenmuster
Bereket	Rufnamenmuster
Beyaz	Rufnamenmuster
Bikmaz	Rufnamenmuster
Bilecen	Rufnamenmuster
Bilen	Rufnamenmuster
Bilge	Rufnamenmuster
Bilgen	Rufnamenmuster
Bilgi	Rufnamenmuster
Bilgic	Rufnamenmuster
Bilgili	Rufnamenmuster
Bilgin	Rufnamenmuster
Bilican	Rufnamenmuster
Bilici	Rufnamenmuster
Bilim	Rufnamenmuster
Bilir	Rufnamenmuster
Binay	Rufnamenmuster
Bingül	Rufnamenmuster
Birinci	Rufnamenmuster
Bolat	Rufnamenmuster
Boyraz	Rufnamenmuster
Bozdag	Rufnamenmuster
Bozdogan	Rufnamenmuster
Bozkurt	Rufnamenmuster
Budak	Rufnamenmuster
Bulat	Rufnamenmuster
Bulut	Rufnamenmuster
Burcak	Rufnamenmuster
Bülbül	Rufnamenmuster
Büyük	Rufnamenmuster
Büyükdag	Rufnamenmuster
Cagdas	Rufnamenmuster
Caglar	Rufnamenmuster
Caglayan	Rufnamenmuster
Cagli	Rufnamenmuster
Cagliyan	Rufnamenmuster
Cakal	Rufnamenmuster
Cakaloglu	Rufnamenmuster
Cakin	Rufnamenmuster
Cakir	Rufnamenmuster
Cakmak	Rufnamenmuster
Calis	Rufnamenmuster
Caliskan	Rufnamenmuster
Cam	Rufnamenmuster
Camgöz	Rufnamenmuster
Camoglu	Rufnamenmuster
Can	Rufnamenmuster
Canan	Rufnamenmuster
Cananoglu	Rufnamenmuster
Canbek	Rufnamenmuster
Candan	Rufnamenmuster
Candar	Rufnamenmuster
Candas	Rufnamenmuster
Cankur	Rufnamenmuster
Canli	Rufnamenmuster
Canoglu	Rufnamenmuster
Capkin	Rufnamenmuster
Caylak	Rufnamenmuster
Caymaz	Rufnamenmuster
Cecen	Rufnamenmuster
Celebi	Rufnamenmuster
Celebioglu	Rufnamenmuster
Celik	Rufnamenmuster
Celikbilek	Rufnamenmuster
Celikel	Rufnamenmuster
Celikkiran	Rufnamenmuster
Celikkol	Rufnamenmuster
Celikten	Rufnamenmuster
Cesur	Rufnamenmuster
Cetin	Rufnamenmuster
Cevik	Rufnamenmuster
Ceylan	Rufnamenmuster
Cicek	Rufnamenmuster
Cigdem	Rufnamenmuster
Cigerli	Rufnamenmuster
Cihan	Rufnamenmuster
Cihangir	Rufnamenmuster
Cilesiz	Rufnamenmuster
Cimen	Rufnamenmuster
Cin	Rufnamenmuster
Cinar	Rufnamenmuster
Civan	Rufnamenmuster
Civelek	Rufnamenmuster
Duman	Rufnamenmuster
Dumanoglu	Rufnamenmuster
Duran	Rufnamenmuster
Durcan	Rufnamenmuster
Durdu	Rufnamenmuster
Durmaz	Rufnamenmuster
Durmus	Rufnamenmuster
Durmusoglu	Rufnamenmuster
Durna	Rufnamenmuster
Dursun	Rufnamenmuster
Durukan	Rufnamenmuster
Durur	Rufnamenmuster
Duygu	Rufnamenmuster
Duygulu	Rufnamenmuster
Dönmez	Rufnamenmuster
Düsünceli	Rufnamenmuster
Düzen	Rufnamenmuster
Düzenli	Rufnamenmuster
Düzgün	Rufnamenmuster
Ecevit	Rufnamenmuster
Edip	Rufnamenmuster
Efe	Rufnamenmuster
Efendi	Rufnamenmuster
Egilmez	Rufnamenmuster
El	Rufnamenmuster
Eliacik	Rufnamenmuster
Elibol	Rufnamenmuster
Elmas	Rufnamenmuster
Emek	Rufnamenmuster
Emeksiz	Rufnamenmuster
Er	Rufnamenmuster
Erat	Rufnamenmuster
Erdem	Rufnamenmuster
Erden	Rufnamenmuster
Erdi	Rufnamenmuster
Ergen	Rufnamenmuster
Ergin	Rufnamenmuster
Erkovan	Rufnamenmuster
Ermis	Rufnamenmuster
Eroglu	Rufnamenmuster
Erol	Rufnamenmuster
Ertem	Rufnamenmuster
Erten	Rufnamenmuster
Esen	Rufnamenmuster
Esgin	Rufnamenmuster
Eski	Rufnamenmuster
Eskin	Rufnamenmuster
Essiz	Rufnamenmuster
Evren	Rufnamenmuster
Eyidogan	Rufnamenmuster
Ferah	Rufnamenmuster
Fidan	Rufnamenmuster
Filiz	Rufnamenmuster
Firtina	Rufnamenmuster
Gaygusuz	Rufnamenmuster
Gayretli	Rufnamenmuster
Geyik	Rufnamenmuster
Girgin	Rufnamenmuster
Gök	Rufnamenmuster
Gökce	Rufnamenmuster
Göklü	Rufnamenmuster
Gökoglu	Rufnamenmuster
Göksal	Rufnamenmuster
Göksel	Rufnamenmuster
Göl	Rufnamenmuster
Gönen	Rufnamenmuster
Gönül	Rufnamenmuster
Gönültas	Rufnamenmuster
Görgü	Rufnamenmuster
Görgülü	Rufnamenmuster
Gözen	Rufnamenmuster
Gözütok	Rufnamenmuster
Güc	Rufnamenmuster
Güclü	Rufnamenmuster
Gül	Rufnamenmuster
Gülacti	Rufnamenmuster
Gülbahce	Rufnamenmuster
Güldal	Rufnamenmuster
Güldali	Rufnamenmuster
Güldü	Rufnamenmuster
Güler	Rufnamenmuster
Güllü	Rufnamenmuster
Gülmen	Rufnamenmuster
Güloglu	Rufnamenmuster
Gülüm	Rufnamenmuster
Gümüs	Rufnamenmuster
Gün	Rufnamenmuster
Günaydin	Rufnamenmuster
Gündes	Rufnamenmuster
Gündog	Rufnamenmuster
Gündogan	Rufnamenmuster
Gündogar	Rufnamenmuster
Gündogdu	Rufnamenmuster
Gündogmus	Rufnamenmuster
Gündüz	Rufnamenmuster
Günebakan	Rufnamenmuster
Günes	Rufnamenmuster
Güney	Rufnamenmuster
Güneysu	Rufnamenmuster
Güngör	Rufnamenmuster
Karakis	Rufnamenmuster
Karakulak	Rufnamenmuster
Karakus	Rufnamenmuster
Karanfil	Rufnamenmuster
Karatay	Rufnamenmuster
Karayel	Rufnamenmuster
Karlidag	Rufnamenmuster
Kartal	Rufnamenmuster
Kavak	Rufnamenmuster
Kaya	Rufnamenmuster
Kayabasi	Rufnamenmuster
Kayacik	Rufnamenmuster
Kayadelen	Rufnamenmuster
Kayalar	Rufnamenmuster
Kayaoglu	Rufnamenmuster
Kayar	Rufnamenmuster
Kaygisiz	Rufnamenmuster
Kaygusuz	Rufnamenmuster
Kaynak	Rufnamenmuster
Keklik	Rufnamenmuster
Keles	Rufnamenmuster
Kelesoglu	Rufnamenmuster
Keskinkilic	Rufnamenmuster
Kibar	Rufnamenmuster
Kilic	Rufnamenmuster
Kilickeser	Rufnamenmuster
Kilicli	Rufnamenmuster
Kilicoglu	Rufnamenmuster
Kilinc	Rufnamenmuster
Kinay	Rufnamenmuster
Kir	Rufnamenmuster
Kiran	Rufnamenmuster
Kirci	Rufnamenmuster
Kirmizi	Rufnamenmuster
Kizil	Rufnamenmuster
Kizildag	Rufnamenmuster
Kizilyel	Rufnamenmuster
Koc	Rufnamenmuster
Kocadag	Rufnamenmuster
Kocaman	Rufnamenmuster
Kocas	Rufnamenmuster
Kocatepe	Rufnamenmuster
Kocoglu	Rufnamenmuster
Kolay	Rufnamenmuster
Korkmaz	Rufnamenmuster
Korkusuz	Rufnamenmuster
Koyun	Rufnamenmuster
Kuralay	Rufnamenmuster
Kurc	Rufnamenmuster
Kursun	Rufnamenmuster
Kurt	Rufnamenmuster
Kurtoglu	Rufnamenmuster
Kurtul	Rufnamenmuster
Kurun	Rufnamenmuster
Kusoglu	Rufnamenmuster
Kutay	Rufnamenmuster
Kutlu	Rufnamenmuster
Kutlucan	Rufnamenmuster
Kuvvet	Rufnamenmuster
Kuvvetli	Rufnamenmuster
Kuzey	Rufnamenmuster
Kuzu	Rufnamenmuster
Kuzuoglu	Rufnamenmuster
Kök	Rufnamenmuster
Köken	Rufnamenmuster
Köklü	Rufnamenmuster
Köksal	Rufnamenmuster
Köksalan	Rufnamenmuster
Lacin	Rufnamenmuster
Lekesiz	Rufnamenmuster
Mart	Rufnamenmuster
Mavi	Rufnamenmuster
Medeni	Rufnamenmuster
Menekse	Rufnamenmuster
Menevse	Rufnamenmuster
Meral	Rufnamenmuster
Mercan	Rufnamenmuster
Mercanoglu	Rufnamenmuster
Mermer	Rufnamenmuster
Mermeroglu	Rufnamenmuster
Mermertas	Rufnamenmuster
Mert	Rufnamenmuster
Mertoglu	Rufnamenmuster
Mutlu	Rufnamenmuster
Namli	Rufnamenmuster
Nas	Rufnamenmuster
Nazik	Rufnamenmuster
Nehir	Rufnamenmuster
Nergis	Rufnamenmuster
Nergiz	Rufnamenmuster
Nuray	Rufnamenmuster
Nurdogan	Rufnamenmuster
Ocak	Rufnamenmuster
Oflaz	Rufnamenmuster
Ok	Rufnamenmuster
Okan	Rufnamenmuster
Okumus	Rufnamenmuster
Okur	Rufnamenmuster
Olcay	Rufnamenmuster
Olgun	Rufnamenmuster
Senol	Rufnamenmuster
Serbest	Rufnamenmuster
Seref	Rufnamenmuster
Sert	Rufnamenmuster
Serttas	Rufnamenmuster
Sevda	Rufnamenmuster
Sevdi	Rufnamenmuster
Sevgi	Rufnamenmuster
Sevgili	Rufnamenmuster
Sevil	Rufnamenmuster
Sevilmis	Rufnamenmuster
Sevim	Rufnamenmuster
Sevimli	Rufnamenmuster
Sevinc	Rufnamenmuster
Sevindi	Rufnamenmuster
Sevindik	Rufnamenmuster
Sevis	Rufnamenmuster
Sevket	Rufnamenmuster
Sevki	Rufnamenmuster
Sezen	Rufnamenmuster
Sezer	Rufnamenmuster
Sezgin	Rufnamenmuster
Simsek	Rufnamenmuster
Solmaz	Rufnamenmuster
Sormaz	Rufnamenmuster
Soy	Rufnamenmuster
Soydan	Rufnamenmuster
Soydas	Rufnamenmuster
Soysal	Rufnamenmuster
Sungur	Rufnamenmuster
Sögüt	Rufnamenmuster
Sönmez	Rufnamenmuster
Sümbül	Rufnamenmuster
Tac	Rufnamenmuster
Tagay	Rufnamenmuster
Talay	Rufnamenmuster
Tas	Rufnamenmuster
Tasan	Rufnamenmuster
Tasar	Rufnamenmuster
Tasdan	Rufnamenmuster
Tasdelen	Rufnamenmuster
Tasgin	Rufnamenmuster
Taskin	Rufnamenmuster
Taskiran	Rufnamenmuster
Tastan	Rufnamenmuster
Tasyürek	Rufnamenmuster
Tay	Rufnamenmuster
Taylan	Rufnamenmuster
Tazegül	Rufnamenmuster
Teke	Rufnamenmuster
Acartürk	Kompositionelles Motiv
Akay	Kompositionelles Motiv
Akaydin	Kompositionelles Motiv
Akbal	Kompositionelles Motiv
Akbalik	Kompositionelles Motiv
Akbay	Kompositionelles Motiv
Akbayir	Kompositionelles Motiv
Akbayrak	Kompositionelles Motiv
Akbudak	Kompositionelles Motiv
Akbulut	Kompositionelles Motiv
Akcakaya	Kompositionelles Motiv
Akcakoca	Kompositionelles Motiv
Akcan	Kompositionelles Motiv
Akcetin	Kompositionelles Motiv
Akcicek	Kompositionelles Motiv
Akdas	Kompositionelles Motiv
Akdemir	Kompositionelles Motiv
Akdere	Kompositionelles Motiv
Akdogan	Kompositionelles Motiv
Akduman	Kompositionelles Motiv
Akgöl	Kompositionelles Motiv
Akgüc	Kompositionelles Motiv
Akgül	Kompositionelles Motiv
Akgün	Kompositionelles Motiv
Akgündüz	Kompositionelles Motiv
Akkaya	Kompositionelles Motiv
Akkilic	Kompositionelles Motiv
Akkoc	Kompositionelles Motiv
Akkoca	Kompositionelles Motiv
Akkoyun	Kompositionelles Motiv
Akkurt	Kompositionelles Motiv
Akpinar	Kompositionelles Motiv
Akpolat	Kompositionelles Motiv
Aksahin	Kompositionelles Motiv
Aksoy	Kompositionelles Motiv
Aksu	Kompositionelles Motiv
Aktas	Kompositionelles Motiv
Aktekin	Kompositionelles Motiv
Aktepe	Kompositionelles Motiv
Aktoprak	Kompositionelles Motiv
Aktürk	Kompositionelles Motiv
Akyigit	Kompositionelles Motiv
Akyildiz	Kompositionelles Motiv
Akyol	Kompositionelles Motiv
Akyurt	Kompositionelles Motiv
Alarslan	Kompositionelles Motiv
Alatas	Kompositionelles Motiv
Alcan	Kompositionelles Motiv
Aldemir	Kompositionelles Motiv
Aldogan	Kompositionelles Motiv
Arslantürk	Kompositionelles Motiv
Asarkaya	Kompositionelles Motiv
Aslandag	Kompositionelles Motiv
Aslandogan	Kompositionelles Motiv
Aslaner	Kompositionelles Motiv
Aslantas	Kompositionelles Motiv
Aslantürk	Kompositionelles Motiv
Atabay	Kompositionelles Motiv
Atacan	Kompositionelles Motiv
Atasoy	Kompositionelles Motiv
Atlihan	Kompositionelles Motiv
Ayalp	Kompositionelles Motiv
Ayata	Kompositionelles Motiv
Ayaydin	Kompositionelles Motiv
Aycan	Kompositionelles Motiv
Aycicek	Kompositionelles Motiv
Aydemir	Kompositionelles Motiv
Aydeniz	Kompositionelles Motiv
Aydindag	Kompositionelles Motiv
Aydiner	Kompositionelles Motiv
Aydogan	Kompositionelles Motiv
Aydurmus	Kompositionelles Motiv
Ayer	Kompositionelles Motiv
Aygül	Kompositionelles Motiv
Aygün	Kompositionelles Motiv
Ayhan	Kompositionelles Motiv
Aykan	Kompositionelles Motiv
Aykoc	Kompositionelles Motiv
Aykurt	Kompositionelles Motiv
Aysel	Kompositionelles Motiv
Aysu	Kompositionelles Motiv
Aytac	Kompositionelles Motiv
Aytan	Kompositionelles Motiv
Aytas	Kompositionelles Motiv
Aytekin	Kompositionelles Motiv
Aytemur	Kompositionelles Motiv
Ayyildiz	Kompositionelles Motiv
Bakirtas	Kompositionelles Motiv
Balkaya	Kompositionelles Motiv
Basay	Kompositionelles Motiv
Basdemir	Kompositionelles Motiv
Baskaya	Kompositionelles Motiv
Baskurt	Kompositionelles Motiv
Baspinar	Kompositionelles Motiv
Bastug	Kompositionelles Motiv
Bastürk	Kompositionelles Motiv
Basuslu	Kompositionelles Motiv
Basyigit	Kompositionelles Motiv
Basyurt	Kompositionelles Motiv
Baycan	Kompositionelles Motiv
Baydemir	Kompositionelles Motiv
Baykara	Kompositionelles Motiv
Baytekin	Kompositionelles Motiv
Berkcan	Kompositionelles Motiv
Berktas	Kompositionelles Motiv
Beyazgül	Kompositionelles Motiv
Beydemir	Kompositionelles Motiv
Beytas	Kompositionelles Motiv
Bozdemir	Kompositionelles Motiv
Bozdogan	Kompositionelles Motiv
Bozkaya	Kompositionelles Motiv
Boztas	Kompositionelles Motiv
Boztepe	Kompositionelles Motiv
Bozyigit	Kompositionelles Motiv
Büyükasik	Kompositionelles Motiv
Büyükkaya	Kompositionelles Motiv
Büyükyilmaz	Kompositionelles Motiv
Cakirer	Kompositionelles Motiv
Canbay	Kompositionelles Motiv
Canbolat	Kompositionelles Motiv
Canbulat	Kompositionelles Motiv
Candemir	Kompositionelles Motiv
Caner	Kompositionelles Motiv
Cankaya	Kompositionelles Motiv
Cankurt	Kompositionelles Motiv
Canpolat	Kompositionelles Motiv
Cansu	Kompositionelles Motiv
Cantürk	Kompositionelles Motiv
Catalkaya	Kompositionelles Motiv
Celikbas	Kompositionelles Motiv
Celikbilek	Kompositionelles Motiv
Celikel	Kompositionelles Motiv
Celiker	Kompositionelles Motiv
Celikkanat	Kompositionelles Motiv
Celikkaya	Kompositionelles Motiv
Celikkol	Kompositionelles Motiv
Celiksoy	Kompositionelles Motiv
Celiktas	Kompositionelles Motiv
Cetinalp	Kompositionelles Motiv
Cetinbag	Kompositionelles Motiv
Cetinbas	Kompositionelles Motiv
Cetindag	Kompositionelles Motiv
Cetinel	Kompositionelles Motiv
Cetiner	Kompositionelles Motiv
Cetinkaya	Kompositionelles Motiv
Cetintas	Kompositionelles Motiv
Ceviker	Kompositionelles Motiv
Cinkaya	Kompositionelles Motiv
Cobankara	Kompositionelles Motiv
Coskuner	Kompositionelles Motiv
Erdogan	Kompositionelles Motiv
Erduran	Kompositionelles Motiv
Erdönmez	Kompositionelles Motiv
Erener	Kompositionelles Motiv
Ergenc	Kompositionelles Motiv
Ergezer	Kompositionelles Motiv
Ergül	Kompositionelles Motiv
Ergün	Kompositionelles Motiv
Ergüven	Kompositionelles Motiv
Ergüzel	Kompositionelles Motiv
Erkaya	Kompositionelles Motiv
Erkilic	Kompositionelles Motiv
Erkilinc	Kompositionelles Motiv
Erkoc	Kompositionelles Motiv
Erkurt	Kompositionelles Motiv
Ersoy	Kompositionelles Motiv
Ertas	Kompositionelles Motiv
Ertekin	Kompositionelles Motiv
Ertunc	Kompositionelles Motiv
Ertürk	Kompositionelles Motiv
Eryener	Kompositionelles Motiv
Eryigit	Kompositionelles Motiv
Eryilmaz	Kompositionelles Motiv
Eskiocak	Kompositionelles Motiv
Esmeray	Kompositionelles Motiv
Gencaslan	Kompositionelles Motiv
Gencay	Kompositionelles Motiv
Gencel	Kompositionelles Motiv
Gencer	Kompositionelles Motiv
Genctürk	Kompositionelles Motiv
Gökalp	Kompositionelles Motiv
Gökay	Kompositionelles Motiv
Gökbayrak	Kompositionelles Motiv
Gökbulut	Kompositionelles Motiv
Gökcan	Kompositionelles Motiv
Gökcay	Kompositionelles Motiv
Gökdag	Kompositionelles Motiv
Gökdemir	Kompositionelles Motiv
Gökduman	Kompositionelles Motiv
Göker	Kompositionelles Motiv
Gökkaya	Kompositionelles Motiv
Gökkurt	Kompositionelles Motiv
Gökkus	Kompositionelles Motiv
Gökpinar	Kompositionelles Motiv
Göksen	Kompositionelles Motiv
Göksu	Kompositionelles Motiv
Göksungur	Kompositionelles Motiv
Göktan	Kompositionelles Motiv
Göktas	Kompositionelles Motiv
Göktekin	Kompositionelles Motiv
Göktepe	Kompositionelles Motiv
Gücer	Kompositionelles Motiv
Gülay	Kompositionelles Motiv
Gülbahar	Kompositionelles Motiv
Gülbas	Kompositionelles Motiv
Gülbeyaz	Kompositionelles Motiv
Gülcan	Kompositionelles Motiv
Gülcicek	Kompositionelles Motiv
Gülfirat	Kompositionelles Motiv
Gülhan	Kompositionelles Motiv
Gülpinar	Kompositionelles Motiv
Gülsahin	Kompositionelles Motiv
Gülsen	Kompositionelles Motiv
Gülsoy	Kompositionelles Motiv
Gültekin	Kompositionelles Motiv
Gültepe	Kompositionelles Motiv
Gümüsay	Kompositionelles Motiv
Gümüssoy	Kompositionelles Motiv
Gümüstas	Kompositionelles Motiv
Gümüstekin	Kompositionelles Motiv
Günay	Kompositionelles Motiv
Güner	Kompositionelles Motiv
Güneser	Kompositionelles Motiv
Güneysu	Kompositionelles Motiv
Güntürk	Kompositionelles Motiv
Gürbüzer	Kompositionelles Motiv
Gürsoy	Kompositionelles Motiv
Güzeldemirci	Kompositionelles Motiv
Hasdemir	Kompositionelles Motiv
Haspolat	Kompositionelles Motiv
Ildeniz	Kompositionelles Motiv
Ilkay	Kompositionelles Motiv
Incekara	Kompositionelles Motiv
Isiktas	Kompositionelles Motiv
Kandemir	Kompositionelles Motiv
Kanyilmaz	Kompositionelles Motiv
Kaplaner	Kompositionelles Motiv
Karaahmet	Kompositionelles Motiv
Karaali	Kompositionelles Motiv
Karaalp	Kompositionelles Motiv
Karaarslan	Kompositionelles Motiv
Karaaslan	Kompositionelles Motiv
Karababa	Kompositionelles Motiv
Karabalci	Kompositionelles Motiv
Karabay	Kompositionelles Motiv
Karabel	Kompositionelles Motiv
Karabey	Kompositionelles Motiv
Karabeyaz	Kompositionelles Motiv
Karaboga	Kompositionelles Motiv
Karabudak	Kompositionelles Motiv
Kilicarslan	Kompositionelles Motiv
Kilicaslan	Kompositionelles Motiv
Kilicer	Kompositionelles Motiv
Kilickaya	Kompositionelles Motiv
Kilincarslan	Kompositionelles Motiv
Kircicek	Kompositionelles Motiv
Kirdemir	Kompositionelles Motiv
Kirmizigül	Kompositionelles Motiv
Kirmizitas	Kompositionelles Motiv
Kizilarslan	Kompositionelles Motiv
Kizilaslan	Kompositionelles Motiv
Kizilay	Kompositionelles Motiv
Kiziler	Kompositionelles Motiv
Kizilkan	Kompositionelles Motiv
Kizilkaya	Kompositionelles Motiv
Kizilpinar	Kompositionelles Motiv
Kiziltan	Kompositionelles Motiv
Kiziltas	Kompositionelles Motiv
Kiziltepe	Kompositionelles Motiv
Kiziltoprak	Kompositionelles Motiv
Kocaaslan	Kompositionelles Motiv
Kocaer	Kompositionelles Motiv
Kocakaya	Kompositionelles Motiv
Kocapinar	Kompositionelles Motiv
Kocaslan	Kompositionelles Motiv
Kocatas	Kompositionelles Motiv
Kocatürk	Kompositionelles Motiv
Kocbay	Kompositionelles Motiv
Kocer	Kompositionelles Motiv
Kockaya	Kompositionelles Motiv
Koctürk	Kompositionelles Motiv
Kocyigit	Kompositionelles Motiv
Korkmazer	Kompositionelles Motiv
Kurter	Kompositionelles Motiv
Kutay	Kompositionelles Motiv
Kutbay	Kompositionelles Motiv
Köktas	Kompositionelles Motiv
Köktürk	Kompositionelles Motiv
Kücükakyüz	Kompositionelles Motiv
Kücükal	Kompositionelles Motiv
Kücükaslan	Kompositionelles Motiv
Kücüker	Kompositionelles Motiv
Kücükkaplan	Kompositionelles Motiv
Kücükkaya	Kompositionelles Motiv
Kücüktas	Kompositionelles Motiv
Küpelikilinc	Kompositionelles Motiv
Lundberg	Kompositionelles Motiv
Lundgreen	Kompositionelles Motiv
Lundgren	Kompositionelles Motiv
Lundström	Kompositionelles Motiv
Mavicicek	Kompositionelles Motiv
Mutluer	Kompositionelles Motiv
Nurcan	Kompositionelles Motiv
Oezdogan	Kompositionelles Motiv
Paksoy	Kompositionelles Motiv
Pekdemir	Kompositionelles Motiv
Polatkan	Kompositionelles Motiv
Polattimur	Kompositionelles Motiv
Sahinbas	Kompositionelles Motiv
Sahiner	Kompositionelles Motiv
Sahinkaya	Kompositionelles Motiv
Sahintürk	Kompositionelles Motiv
Sanlialp	Kompositionelles Motiv
Sanlier	Kompositionelles Motiv
Sarialtin	Kompositionelles Motiv
Sarialtun	Kompositionelles Motiv
Sariaydin	Kompositionelles Motiv
Sarican	Kompositionelles Motiv
Saricicek	Kompositionelles Motiv
Saridag	Kompositionelles Motiv
Saridogan	Kompositionelles Motiv
Sarier	Kompositionelles Motiv
Sarigül	Kompositionelles Motiv
Sarikan	Kompositionelles Motiv
Sarikaya	Kompositionelles Motiv
Sarisoy	Kompositionelles Motiv
Saritekin	Kompositionelles Motiv
Sariyildiz	Kompositionelles Motiv
Sarpkaya	Kompositionelles Motiv
Senay	Kompositionelles Motiv
Sencan	Kompositionelles Motiv
Sener	Kompositionelles Motiv
Sengezer	Kompositionelles Motiv
Sengül	Kompositionelles Motiv
Sengün	Kompositionelles Motiv
Senkaya	Kompositionelles Motiv
Senocak	Kompositionelles Motiv
Senpinar	Kompositionelles Motiv
Sensoy	Kompositionelles Motiv
Sentürk	Kompositionelles Motiv
Senyildiz	Kompositionelles Motiv
Senyurt	Kompositionelles Motiv
Sertdemir	Kompositionelles Motiv
Serter	Kompositionelles Motiv
Sertkaya	Kompositionelles Motiv
Seslikaya	Kompositionelles Motiv
Sivrikaya	Kompositionelles Motiv
Songül	Kompositionelles Motiv
Sonkaya	Kompositionelles Motiv
Soyak	Kompositionelles Motiv
Ulusan	Kompositionelles Motiv
Ulusoy	Kompositionelles Motiv
Ulutas	Kompositionelles Motiv
Ulutürk	Kompositionelles Motiv
Uslubas	Kompositionelles Motiv
Uzunay	Kompositionelles Motiv
Uzunel	Kompositionelles Motiv
Uzuner	Kompositionelles Motiv
Uzunhan	Kompositionelles Motiv
Uzunkaya	Kompositionelles Motiv
Uzuntas	Kompositionelles Motiv
Yalcinkaya	Kompositionelles Motiv
Yavuzaslan	Kompositionelles Motiv
Yavuzer	Kompositionelles Motiv
Yenidogan	Kompositionelles Motiv
Yerlikaya	Kompositionelles Motiv
Yesilay	Kompositionelles Motiv
Yesilbas	Kompositionelles Motiv
Yesilirmak	Kompositionelles Motiv
Yesilkaya	Kompositionelles Motiv
Yesiltas	Kompositionelles Motiv
Yesiltepe	Kompositionelles Motiv
Yesilöz	Kompositionelles Motiv
Yigiter	Kompositionelles Motiv
Yigitsoy	Kompositionelles Motiv
Yildirimer	Kompositionelles Motiv
Yildizbas	Kompositionelles Motiv
Yildizhan	Kompositionelles Motiv
Yilmazer	Kompositionelles Motiv
Yilmaztürk	Kompositionelles Motiv
Yücebas	Kompositionelles Motiv
Yüceer	Kompositionelles Motiv
Yücetas	Kompositionelles Motiv
Yüksekkaya	Kompositionelles Motiv
Öner	Kompositionelles Motiv
Özalp	Kompositionelles Motiv
Özarslan	Kompositionelles Motiv
Özaslan	Kompositionelles Motiv
Özavci	Kompositionelles Motiv
Özay	Kompositionelles Motiv
Özaydin	Kompositionelles Motiv
Özbakir	Kompositionelles Motiv
Özbas	Kompositionelles Motiv
Özbay	Kompositionelles Motiv
Özbilen	Kompositionelles Motiv
Özbolat	Kompositionelles Motiv
Özcakir	Kompositionelles Motiv
Özcan	Kompositionelles Motiv
Özcelik	Kompositionelles Motiv
Özcetin	Kompositionelles Motiv
Aal	Beruf
Abaci	Beruf
Abbetmeier	Beruf
Abbetmeyer	Beruf
Abkemeier	Beruf
Abkemeyer	Beruf
Ablassmaier	Beruf
Ablassmeier	Beruf
Ablassmeir	Beruf
Ablaßmaier	Beruf
Ablaßmayer	Beruf
Ablaßmeier	Beruf
Ablaßmeir	Beruf
Abmaier	Beruf
Abmair	Beruf
Abmayr	Beruf
Abmeier	Beruf
Abmeyer	Beruf
Absenger	Beruf
Absmaier	Beruf
Absmayer	Beruf
Absmayr	Beruf
Absmeier	Beruf
Abtmaier	Beruf
Abtmayr	Beruf
Abtmeier	Beruf
Abtmeyer	Beruf
Achermann	Beruf
Achmiller	Beruf
Achmüller	Beruf
Acht	Beruf
Achter	Beruf
Achtermeier	Beruf
Achtermeyer	Beruf
Achtert	Beruf
Achtmann	Beruf
Achtner	Beruf
Acker	Beruf
Ackerbauer	Beruf
Ackerer	Beruf
Ackerknecht	Beruf
Ackerl	Beruf
Ackermaier	Beruf
Ackerman	Beruf
Ackermann	Beruf
Ackermanns	Beruf
Ackermans	Beruf
Ackermeier	Beruf
Ackers	Beruf
Ackert	Beruf
Crell	Beruf
Cremer	Beruf
Cremerius	Beruf
Cremers	Beruf
Cremmer	Beruf
Creutzmann	Beruf
Creuzmann	Beruf
Cristal	Beruf
Cromer	Beruf
Crueger	Beruf
Cruse	Beruf
Crusius	Beruf
Cruße	Beruf
Crämer	Beruf
Cröger	Beruf
Crömer	Beruf
Crüger	Beruf
Csermak	Beruf
Cubuk	Beruf
Cubukcu	Beruf
Cuepper	Beruf
Cueppers	Beruf
Cuesters	Beruf
Cuiper	Beruf
Culcu	Beruf
Culha	Beruf
Culhaci	Beruf
Cuper	Beruf
Curio	Beruf
Custer	Beruf
Custers	Beruf
Custodis	Beruf
Cuwalsky	Beruf
Cuyper	Beruf
Cuypers	Beruf
Cymerman	Beruf
Czaika	Beruf
Czajka	Beruf
Czayka	Beruf
Czeicke	Beruf
Czeike	Beruf
Czeitler	Beruf
Czejka	Beruf
Czermak	Beruf
Czerwenka	Beruf
Czerwinka	Beruf
Czeschelski	Beruf
Czeschelsky	Beruf
Czeschla	Beruf
Czeschlick	Beruf
Gonschior	Beruf
Gonschiorek	Beruf
Gonschor	Beruf
Gonschoreck	Beruf
Gonschorek	Beruf
Gonschorowitz	Beruf
Gonschorr	Beruf
Gonschorreck	Beruf
Gonschorrek	Beruf
Gonserkewitz	Beruf
Gonsior	Beruf
Gonsiorczyk	Beruf
Gonsiorek	Beruf
Gontcharov	Beruf
Gontcharova	Beruf
Gontschar	Beruf
Gontscharenko	Beruf
Gontscharov	Beruf
Gontscharova	Beruf
Gontscharow	Beruf
Gontscharowa	Beruf
Gontscharuk	Beruf
Gonzoreck	Beruf
Goos	Beruf
Goosmann	Beruf
Gooß	Beruf
Gooßmann	Beruf
Gopfauf	Beruf
Gorniaczyk	Beruf
Gorniak	Beruf
Gorniatzek	Beruf
Gornick	Beruf
Gornig	Beruf
Gornigk	Beruf
Gornik	Beruf
Gornioczek	Beruf
Gorniok	Beruf
Gorniotzek	Beruf
Gorobec	Beruf
Gorobets	Beruf
Gorobez	Beruf
Gortemaker	Beruf
Gottsacker	Beruf
Goudschmidt	Beruf
Goudsmid	Beruf
Goudsmit	Beruf
Graaf	Beruf
Graafen	Beruf
Graaff	Beruf
Graaffe	Beruf
Jungrichter	Beruf
Jungritter	Beruf
Jungschaffer	Beruf
Jungschlaeger	Beruf
Jungschläger	Beruf
Jungschmidt	Beruf
Jungscholz	Beruf
Jungtorius	Beruf
Jungweber	Beruf
Jungwerth	Beruf
Jungwirt	Beruf
Jungwirth	Beruf
Justmeyer	Beruf
Jäger	Beruf
Jägerbauer	Beruf
Jägerhuber	Beruf
Jägermair	Beruf
Jägermann	Beruf
Jägermeyr	Beruf
Jägers	Beruf
Jöstingmeier	Beruf
Jöstingmeyer	Beruf
Jürgenmeier	Beruf
Jürgenmeyer	Beruf
Jürgenschellert	Beruf
Jürgensmeier	Beruf
Jürgensmeyer	Beruf
Jüttemeier	Beruf
Jüttemeyer	Beruf
Kaack	Beruf
Kaak	Beruf
Kaakschlief	Beruf
Kabak	Beruf
Kabakci	Beruf
Kabe	Beruf
Kabel	Beruf
Kabelmacher	Beruf
Kabelmann	Beruf
Kabernagel	Beruf
Kabes	Beruf
Kachel	Beruf
Kacheleck	Beruf
Kachelek	Beruf
Kachellek	Beruf
Kachelmann	Beruf
Kachelmus	Beruf
Kachelmuss	Beruf
Kachelmuß	Beruf
Kachl	Beruf
Kachler	Beruf
Konincks	Beruf
Koning	Beruf
Konings	Beruf
Konink	Beruf
Koninkx	Beruf
Konukcu	Beruf
Konwisarz	Beruf
Konwischer	Beruf
Konwiser	Beruf
Konwisorsch	Beruf
Konwisorz	Beruf
Konwissorz	Beruf
Koock	Beruf
Kook	Beruf
Kool	Beruf
Koop	Beruf
Kooper	Beruf
Koopers	Beruf
Koopman	Beruf
Koopmann	Beruf
Koopmanns	Beruf
Koopmans	Beruf
Koops	Beruf
Kopec	Beruf
Koper	Beruf
Koperschmidt	Beruf
Kopetz	Beruf
Kopez	Beruf
Kopfer	Beruf
Kopfermann	Beruf
Kopfmiller	Beruf
Kopfmüller	Beruf
Kopfnagel	Beruf
Kophal	Beruf
Kophamel	Beruf
Kopman	Beruf
Kopmann	Beruf
Kopmans	Beruf
Kopmeier	Beruf
Kopmeyer	Beruf
Koppelhuber	Beruf
Koppelmeier	Beruf
Koppelmeyer	Beruf
Kopper	Beruf
Koppermann	Beruf
Koppernagel	Beruf
Koppers	Beruf
Kopperschlaeger	Beruf
Kopperschläger	Beruf
Kopperschmidt	Beruf
Lederer	Beruf
Ledergerber	Beruf
Lederhaas	Beruf
Lederhas	Beruf
Lederhos	Beruf
Lederhose	Beruf
Lederhoss	Beruf
Lederle	Beruf
Ledermann	Beruf
Leeder	Beruf
Leerhuber	Beruf
Leermann	Beruf
Leesmeister	Beruf
Lefaivre	Beruf
Lefeber	Beruf
Lefebre	Beruf
Lefebvre	Beruf
Lefeuvre	Beruf
Lefevre	Beruf
Leffler	Beruf
Lefler	Beruf
Lefèbre	Beruf
Lefèvre	Beruf
Legel	Beruf
Legeler	Beruf
Legl	Beruf
Legler	Beruf
Lehbauer	Beruf
Lehder	Beruf
Lehe	Beruf
Lehenbauer	Beruf
Lehenherr	Beruf
Lehenmeier	Beruf
Leher	Beruf
Lehermaier	Beruf
Lehermeier	Beruf
Lehert	Beruf
Lehmacher	Beruf
Lehmaier	Beruf
Lehmair	Beruf
Lehmann	Beruf
Lehmayer	Beruf
Lehmayr	Beruf
Lehmeier	Beruf
Lehmer	Beruf
Lehmert	Beruf
Lehmeyer	Beruf
Lehmköster	Beruf
Lehmler	Beruf
Lehner	Beruf
Ohlenschläger	Beruf
Ohlhorn	Beruf
Ohlig	Beruf
Ohliger	Beruf
Ohligs	Beruf
Ohligschlaeger	Beruf
Ohligschläger	Beruf
Ohlmüller	Beruf
Ohlrog	Beruf
Ohlroge	Beruf
Ohlrogg	Beruf
Ohlrogge	Beruf
Ohlroggen	Beruf
Ohlschlägel	Beruf
Ohlschläger	Beruf
Oksenhirdt	Beruf
Okutan	Beruf
Okutucu	Beruf
Okuyucu	Beruf
Olbeter	Beruf
Olboeter	Beruf
Olböter	Beruf
Oldermann	Beruf
Olderog	Beruf
Olearczyk	Beruf
Olearius	Beruf
Oleartschik	Beruf
Olejak	Beruf
Olejar	Beruf
Olejarczyk	Beruf
Olejarova	Beruf
Olejars	Beruf
Olejartz	Beruf
Olejarz	Beruf
Olejnicek	Beruf
Olejnick	Beruf
Olejnicki	Beruf
Olejniczak	Beruf
Olejniezak	Beruf
Olejnik	Beruf
Olejnikov	Beruf
Olejnikova	Beruf
Olejnikow	Beruf
Olejnikowa	Beruf
Olejnitzak	Beruf
Olejnizak	Beruf
Olejok	Beruf
Oleynicki	Beruf
Oleyniczak	Beruf
Oleynik	Beruf
Scheib	Beruf
Scheible	Beruf
Scheid	Beruf
Scheide	Beruf
Scheideler	Beruf
Scheidemann	Beruf
Scheider	Beruf
Scheiderer	Beruf
Scheidhauer	Beruf
Scheidler	Beruf
Scheidmann	Beruf
Scheidmeir	Beruf
Scheidmeyer	Beruf
Scheidmiller	Beruf
Scheidmüller	Beruf
Scheidner	Beruf
Scheidt	Beruf
Scheidter	Beruf
Scheidthauer	Beruf
Scheidtmann	Beruf
Scheifel	Beruf
Scheifele	Beruf
Scheiffele	Beruf
Scheiffelen	Beruf
Scheifl	Beruf
Scheifler	Beruf
Scheika	Beruf
Scheike	Beruf
Schein	Beruf
Scheindel	Beruf
Scheindl	Beruf
Scheindlin	Beruf
Scheinemann	Beruf
Scheiner	Beruf
Scheinert	Beruf
Scheinmann	Beruf
Scheins	Beruf
Scheit	Beruf
Scheitel	Beruf
Scheiter	Beruf
Scheiterer	Beruf
Scheiterle	Beruf
Scheiterlein	Beruf
Scheithauer	Beruf
Scheitl	Beruf
Scheitle	Beruf
Scheitmann	Beruf
Scheitmüller	Beruf
Scheitterer	Beruf
Scheitterlein	Beruf
Aab	Rufname
Aagten	Rufname
Aal	Rufname
Aalbers	Rufname
Aalberts	Rufname
Aarents	Rufname
Aarns	Rufname
Aaron	Rufname
Abas	Rufname
Abay	Rufname
Abb	Rufname
Abbas	Rufname
Abbasi	Rufname
Abbe	Rufname
Abbel	Rufname
Abben	Rufname
Abbes	Rufname
Abbing	Rufname
Abbink	Rufname
Abbold	Rufname
Abbrecht	Rufname
Abdalla	Rufname
Abdallah	Rufname
Abdalrahman	Rufname
Abdel-Karim	Rufname
Abdelaziz	Rufname
Abdelhamid	Rufname
Abdelkader	Rufname
Abdelkarim	Rufname
Abdella	Rufname
Abdellah	Rufname
Abdellatif	Rufname
Abdelrahman	Rufname
Abderrahman	Rufname
Abderrahmane	Rufname
Abdul-Karim	Rufname
Abdulaziz	Rufname
Abdulhamid	Rufname
Abdulkader	Rufname
Abdulkadir	Rufname
Abdulkarim	Rufname
Abdulla	Rufname
Abdullah	Rufname
Abdullatif	Rufname
Abdulrahman	Rufname
Abdurahman	Rufname
Abdurrahman	Rufname
Abe	Rufname
Abel	Rufname
Abele	Rufname
Cemal	Rufname
Cemil	Rufname
Cenek	Rufname
Cengiz	Rufname
Cesar	Rufname
Cesare	Rufname
Cesareo	Rufname
Cesari	Rufname
Cesario	Rufname
Cesaro	Rufname
Cetin	Rufname
Ceulen	Rufname
Chalil	Rufname
Charcenko	Rufname
Charisius	Rufname
Charitius	Rufname
Charles	Rufname
Chartschenko	Rufname
Chasan	Rufname
Chasanoglou	Rufname
Chimenti	Rufname
Chimento	Rufname
Chimienti	Rufname
Chiumenti	Rufname
Chiumento	Rufname
Chlaus	Rufname
Chlaußen	Rufname
Chlaß	Rufname
Chlodwig	Rufname
Choma	Rufname
Chomenko	Rufname
Chomicz	Rufname
Chomitsch	Rufname
Chrisstmann	Rufname
Christ	Rufname
Christa	Rufname
Christahn	Rufname
Christan	Rufname
Christandl	Rufname
Christann	Rufname
Christans	Rufname
Christansen	Rufname
Christe	Rufname
Christein	Rufname
Christeiner	Rufname
Christeinicke	Rufname
Christeit	Rufname
Christel	Rufname
Christeleit	Rufname
Christelsohn	Rufname
Gabor	Rufname
Gabriel	Rufname
Gabrieljürgens	Rufname
Gabriels	Rufname
Gaebel	Rufname
Gaebele	Rufname
Gaebelein	Rufname
Gaebelt	Rufname
Gaebert	Rufname
Gaebhard	Rufname
Gaeble	Rufname
Gaevert	Rufname
Gaewert	Rufname
Gafel	Rufname
Gahrmann	Rufname
Gailing	Rufname
Gais	Rufname
Gaise	Rufname
Gaiss	Rufname
Gaiß	Rufname
Gales	Rufname
Gall	Rufname
Gallagher	Rufname
Gallaher	Rufname
Galle	Rufname
Gallelli	Rufname
Galler	Rufname
Galles	Rufname
Galletti	Rufname
Galletto	Rufname
Galli	Rufname
Gallo	Rufname
Gallus	Rufname
Gally	Rufname
Galy	Rufname
Gamal	Rufname
Gammel	Rufname
Gang	Rufname
Gangl	Rufname
Gangloff	Rufname
Gangluff	Rufname
Gangolf	Rufname
Gangolff	Rufname
Garbade	Rufname
Garber	Rufname
Garberding	Rufname
Garbers	Rufname
Garbert	Rufname
Garbode	Rufname
Garbracht	Rufname
Heynrichs	Rufname
Heyns	Rufname
Heynsen	Rufname
Heynsohn	Rufname
Heyntz	Rufname
Heynz	Rufname
Heyse	Rufname
Heysing	Rufname
Heß	Rufname
Heße	Rufname
Heßel	Rufname
Heßelink	Rufname
Heßelmann	Rufname
Heßelmans	Rufname
Heßeln	Rufname
Heßenius	Rufname
Heßlein	Rufname
Hielbig	Rufname
Hientsch	Rufname
Hientz	Rufname
Hientzsch	Rufname
Hienz	Rufname
Hienzsch	Rufname
Hierl	Rufname
Hierle	Rufname
Hierlein	Rufname
Hierlemann	Rufname
Hierlmann	Rufname
Hiermann	Rufname
Hierold	Rufname
Hieronimi	Rufname
Hieronimus	Rufname
Hieronymi	Rufname
Hieronymus	Rufname
Hilaire	Rufname
Hilal	Rufname
Hilarius	Rufname
Hilber	Rufname
Hilberer	Rufname
Hilbers	Rufname
Hilbert	Rufname
Hilberth	Rufname
Hilberts	Rufname
Hilbertz	Rufname
Hilbich	Rufname
Hilbig	Rufname
Hilbrand	Rufname
Hilbrands	Rufname
Hilbrandt	Rufname
Hilbrans	Rufname
Kubatzsch	Rufname
Kubazki	Rufname
Kubb	Rufname
Kubbat	Rufname
Kubbetat	Rufname
Kubbig	Rufname
Kubbutat	Rufname
Kube	Rufname
Kubecek	Rufname
Kubeck	Rufname
Kubecka	Rufname
Kubecki	Rufname
Kubeczka	Rufname
Kubeit	Rufname
Kubek	Rufname
Kubet	Rufname
Kubetat	Rufname
Kubeth	Rufname
Kubetscheck	Rufname
Kubetschek	Rufname
Kubetzek	Rufname
Kubetzka	Rufname
Kubetzki	Rufname
Kubiack	Rufname
Kubiak	Rufname
Kubica	Rufname
Kubicek	Rufname
Kubick	Rufname
Kubicka	Rufname
Kubicke	Rufname
Kubicki	Rufname
Kubicky	Rufname
Kubiczeck	Rufname
Kubiczek	Rufname
Kubig	Rufname
Kubigk	Rufname
Kubik	Rufname
Kubilay	Rufname
Kubitscheck	Rufname
Kubitschek	Rufname
Kubitza	Rufname
Kubitzek	Rufname
Kubitzka	Rufname
Kubitzke	Rufname
Kubitzki	Rufname
Kubitzky	Rufname
Kubiza	Rufname
Kubizek	Rufname
Kubo	Rufname
Kubocz	Rufname
Mertten	Rufname
Merttens	Rufname
Mertyn	Rufname
Merwald	Rufname
Merwart	Rufname
Merwarth	Rufname
Merwerth	Rufname
Merx	Rufname
Mesterharm	Rufname
Mesterjahn	Rufname
Metag	Rufname
Metak	Rufname
Metasch	Rufname
Metaschk	Rufname
Metslaf	Rufname
Mett	Rufname
Mettag	Rufname
Mette	Rufname
Metten	Rufname
Metz	Rufname
Metze	Rufname
Metzlaf	Rufname
Metzlaff	Rufname
Metzlaw	Rufname
Meuwesen	Rufname
Meuwissen	Rufname
Meuwsen	Rufname
Meuwssen	Rufname
Meuwßen	Rufname
Meven	Rufname
Meves	Rufname
Mevihsen	Rufname
Mevis	Rufname
Mevissen	Rufname
Mevius	Rufname
Mevißen	Rufname
Mevs	Rufname
Mewe	Rufname
Mewen	Rufname
Mewes	Rufname
Mewing	Rufname
Mewis	Rufname
Mewissen	Rufname
Mewius	Rufname
Mewißen	Rufname
Mews	Rufname
Mewus	Rufname
Meybert	Rufname
Meyberth	Rufname
Meyborg	Rufname
Reintjes	Rufname
Reintke	Rufname
Reints	Rufname
Reintsch	Rufname
Reintsema	Rufname
Reintzsch	Rufname
Reinwald	Rufname
Reinwaldt	Rufname
Reinwardt	Rufname
Reinwart	Rufname
Reinwarth	Rufname
Reinwein	Rufname
Reipert	Rufname
Reipold	Rufname
Reipprich	Rufname
Reiprecht	Rufname
Reiprich	Rufname
Reipricht	Rufname
Reis	Rufname
Reischke	Rufname
Reisel	Rufname
Reisen	Rufname
Reisle	Rufname
Reiss	Rufname
Reisse	Rufname
Reissel	Rufname
Reissen	Rufname
Reissl	Rufname
Reissle	Rufname
Reisslein	Rufname
Reisz	Rufname
Reitz	Rufname
Reitze	Rufname
Reitzel	Rufname
Reitzer	Rufname
Reitzl	Rufname
Reitzle	Rufname
Reitzlein	Rufname
Reitzler	Rufname
Reitzner	Rufname
Reiz	Rufname
Reize	Rufname
Reizel	Rufname
Reizele	Rufname
Reizer	Rufname
Reizle	Rufname
Reizlein	Rufname
Reizler	Rufname
Reizner	Rufname
Reiß	Rufname
Thyssens	Rufname
Thywissen	Rufname
Thywißen	Rufname
Thyzel	Rufname
Thyßen	Rufname
Thänert	Rufname
Thänhardt	Rufname
Thébaud	Rufname
Thöl	Rufname
Thöle	Rufname
Thölen	Rufname
Thöling	Rufname
Thölmann	Rufname
Thömel	Rufname
Thömmes	Rufname
Thön	Rufname
Thöne	Rufname
Thöner	Rufname
Thönert	Rufname
Thönes	Rufname
Thönessen	Rufname
Thönges	Rufname
Thönis	Rufname
Thöniss	Rufname
Thönissen	Rufname
Thöniß	Rufname
Thönißen	Rufname
Thönnehsen	Rufname
Thönnes	Rufname
Thönnesen	Rufname
Thönnessen	Rufname
Thönneßen	Rufname
Thönnihsen	Rufname
Thönnis	Rufname
Thönniss	Rufname
Thönnissen	Rufname
Thönniß	Rufname
Thönnißen	Rufname
Thöns	Rufname
Thönsen	Rufname
Thönsing	Rufname
Thönßen	Rufname
Thöws	Rufname
Thübel	Rufname
Thüm	Rufname
Thümmel	Rufname
Thümmes	Rufname
Thün	Rufname
Thünchen	Rufname
Thüne	Rufname
