text	label
Akman	Rufnamenmuster
Kutbay	Kompositionelles Motiv
Haager	Herkunft
Gurol	Herkunft
Sarikaya	Kompositionelles Motiv
Reiprecht	Rufname
Jeschinsky	Herkunft
Esmeray	Kompositionelles Motiv
Kuzey	Rufnamenmuster
Kabes	Beruf
Nieweg	Wohnstätte
Ackeren	Wohnstätte
Kurt	Rufnamenmuster
Custers	Beruf
Gaevert	Rufname
Aevermann	Herkunft
Taskin	Rufnamenmuster
Gülfirat	Kompositionelles Motiv
Lemberg	Herkunft
Gonschorek	Beruf
Gencay	Kompositionelles Motiv
Büch	Wohnstätte
Taenzel	Übername
Götzger	Herkunft
Heynsohn	Rufname
Brueckner	Herkunft
Gülbahar	Kompositionelles Motiv
Ackerman	Beruf
Schröckel	Übername
Gabor	Rufname
Göktepe	Kompositionelles Motiv
Jaschensky	Herkunft
Merwerth	Rufname
Kleißner	Übername
Schlieperskötter	Wohnstätte
Abasiz	Übername
Klingler	Übername
Christ	Rufname
Ehrfurt	Herkunft
Akgündüz	Kompositionelles Motiv
Ackermanns	Beruf
Brucke	Herkunft
Kleußner	Übername
Guggenmoser	Herkunft
Toepfl	Wohnstätte
Korkusuz	Rufnamenmuster
Javorsky	Herkunft
Lössel	Übername
Grübler	Übername
Scheider	Beruf
Olböter	Beruf
Kleinsorgen	Übername
Kocatürk	Kompositionelles Motiv
Abderrahmane	Rufname
Adamowsky	Herkunft
Gökcek	Herkunft
Thönnißen	Rufname
Akdogan	Kompositionelles Motiv
Songül	Kompositionelles Motiv
Kubicek	Rufname
Legeler	Beruf
Duman	Rufnamenmuster
Erkovan	Rufnamenmuster
Elibol	Rufnamenmuster
Timmerkamp	Wohnstätte
Baskaya	Kompositionelles Motiv
Lefler	Beruf
Jägers	Beruf
Al	Rufnamenmuster
Tasdelen	Rufnamenmuster
Yesiltepe	Kompositionelles Motiv
Grünerbel	Übername
Heynrichs	Rufname
Meuwissen	Rufname
Günaydin	Rufnamenmuster
Lössl	Übername
Schlickert	Wohnstätte
Girgin	Rufnamenmuster
Groen	Wohnstätte
Pusamssies	Übername
Mevißen	Rufname
Ayyildiz	Kompositionelles Motiv
Brodowsky	Herkunft
Eichenseer	Herkunft
Abs	Übername
Reissle	Rufname
Kleinvogel	Übername
Neuhäusler	Herkunft
Akkaya	Kompositionelles Motiv
Özbay	Kompositionelles Motiv
Lundberg	Kompositionelles Motiv
Scheid	Beruf
Gündogmus	Rufnamenmuster
Krummnacker	Wohnstätte
Cakal	Rufnamenmuster
Scheidemann	Beruf
Kubek	Rufname
Schrom	Übername
Aytac	Kompositionelles Motiv
Lehenmeier	Beruf
Yüceer	Kompositionelles Motiv
Akbayrak	Kompositionelles Motiv
Kocatepe	Rufnamenmuster
Olcay	Rufnamenmuster
Hoppenkamp	Wohnstätte
Tagay	Rufnamenmuster
Merx	Rufname
El	Rufnamenmuster
Karayel	Rufnamenmuster
Charisius	Rufname
Groene	Wohnstätte
Hoops	Wohnstätte
Kophal	Beruf
Sarigül	Kompositionelles Motiv
Tophoff	Wohnstätte
Olboeter	Beruf
Aldirmaz	Rufnamenmuster
Thön	Rufname
Karanfil	Rufnamenmuster
Gökce	Rufnamenmuster
Dreißigacker	Übername
Timmerhoff	Wohnstätte
Brummerhoff	Herkunft
Gaebele	Rufname
Gangloff	Rufname
Kircicek	Kompositionelles Motiv
Gripp	Wohnstätte
Kleinmanns	Übername
Eglseer	Herkunft
Scheidmüller	Beruf
Aigenmann	Übername
Honigbaum	Wohnstätte
Achler	Wohnstätte
Aal	Beruf
Pundschuh	Übername
Sariaydin	Kompositionelles Motiv
Erkaya	Kompositionelles Motiv
Reizler	Rufname
Kubick	Rufname
Leithner	Herkunft
Drenkert	Übername
Topkaya	Wohnstätte
Niestrate	Wohnstätte
Groenwald	Wohnstätte
Aydurmus	Kompositionelles Motiv
Kleppel	Übername
Tanzler	Übername
Crämer	Beruf
Guggenbühler	Herkunft
Jastremsky	Herkunft
Schleiff	Wohnstätte
Neufanger	Herkunft
Lundgren	Kompositionelles Motiv
Brueck	Herkunft
Neuhäusser	Herkunft
Karabudak	Kompositionelles Motiv
Thünchen	Rufname
Sentürk	Kompositionelles Motiv
Holzleitner	Wohnstätte
Pühl	Herkunft
Erten	Rufnamenmuster
Calis	Rufnamenmuster
Bekdemir	Rufnamenmuster
Gökbulut	Kompositionelles Motiv
Incekara	Kompositionelles Motiv
Akkurt	Kompositionelles Motiv
Akbulut	Kompositionelles Motiv
Abdellah	Rufname
Lesczinski	Herkunft
Abramowski	Herkunft
Nijhof	Wohnstätte
Eichholtzer	Herkunft
Druckenbrodt	Übername
Kilic	Rufnamenmuster
Lehmacher	Beruf
Cetindag	Kompositionelles Motiv
Lößlein	Übername
Kizilay	Kompositionelles Motiv
Bösefeld	Wohnstätte
Yerlikaya	Kompositionelles Motiv
Gündogan	Rufnamenmuster
Quedenau	Herkunft
Scheidt	Beruf
Adlkofer	Herkunft
Nordenholt	Wohnstätte
Groenhoff	Wohnstätte
Kachellek	Beruf
Atasoy	Kompositionelles Motiv
Sungur	Rufnamenmuster
Dreyssig	Übername
Beyaz	Rufnamenmuster
Caner	Kompositionelles Motiv
Ertürk	Kompositionelles Motiv
Kuzu	Rufnamenmuster
Konwiser	Beruf
Duechting	Übername
Oflaz	Rufnamenmuster
Kulle	Wohnstätte
Koppernagel	Beruf
Griebl	Wohnstätte
Mewe	Rufname
Gülcicek	Kompositionelles Motiv
Reitzel	Rufname
Taleb	Übername
Schlicher	Wohnstätte
Ehrenberg	Herkunft
Jungschläger	Beruf
Scheitmüller	Beruf
Süßmann	Übername
Brodskiy	Herkunft
Heßeln	Rufname
Czeicke	Beruf
Custodis	Beruf
Gründel	Übername
Schug	Übername
Göklü	Rufnamenmuster
Bruchhöfer	Herkunft
Bücheler	Wohnstätte
Özbas	Kompositionelles Motiv
Kachelmuß	Beruf
Groenegraes	Wohnstätte
Koopmann	Beruf
Kilicoglu	Rufnamenmuster
Chomicz	Rufname
Lehmer	Beruf
Cuiper	Beruf
Abbühl	Wohnstätte
Lefèbre	Beruf
Gooß	Beruf
Abbing	Rufname
Chrisstmann	Rufname
Tack	Übername
Gülstorf	Herkunft
Cakin	Rufnamenmuster
Schrickel	Übername
Abaci	Beruf
Lörch	Übername
Topphoff	Wohnstätte
Saritekin	Kompositionelles Motiv
Akaydin	Kompositionelles Motiv
Schlichert	Wohnstätte
Drinkhut	Übername
Gorobets	Beruf
Hilbrandt	Rufname
Kubizek	Rufname
Kocapinar	Kompositionelles Motiv
Aal	Rufname
Caglar	Rufnamenmuster
Kartal	Rufnamenmuster
Charles	Rufname
Nehir	Rufnamenmuster
Grössle	Übername
Crüger	Beruf
Taentzer	Übername
Cevik	Rufnamenmuster
Cetiner	Kompositionelles Motiv
Okutucu	Beruf
Abramovski	Herkunft
Tanzmann	Übername
Köktas	Kompositionelles Motiv
Bilici	Rufnamenmuster
Achorner	Wohnstätte
Achterkamp	Wohnstätte
Erdi	Rufnamenmuster
Sevil	Rufnamenmuster
Kophamel	Beruf
Chiumento	Rufname
Görmer	Herkunft
Achterkirche	Wohnstätte
Achternbosch	Wohnstätte
Adamsky	Herkunft
Abdurrahman	Rufname
Celiktas	Kompositionelles Motiv
Thönessen	Rufname
Gözütok	Rufnamenmuster
Puscz	Übername
Garberding	Rufname
Aslaner	Kompositionelles Motiv
Thömel	Rufname
Celikkanat	Kompositionelles Motiv
Eroglu	Rufnamenmuster
Neuhäuser	Herkunft
Lengfellner	Herkunft
Gales	Rufname
Kubitza	Rufname
Schröthlin	Übername
Löschhorn	Übername
Merttens	Rufname
Jaschinsky	Herkunft
Hieronimus	Rufname
Seslikaya	Kompositionelles Motiv
Klinkerfuss	Übername
Akcakoca	Kompositionelles Motiv
Bozkaya	Kompositionelles Motiv
Basarir	Rufnamenmuster
Reitzl	Rufname
Kleuel	Übername
Eichwald	Herkunft
Oleyniczak	Beruf
Akcicek	Kompositionelles Motiv
Cymerman	Beruf
Aycan	Kompositionelles Motiv
Neuhaußer	Herkunft
Hoop	Wohnstätte
Löwenmuth	Übername
Karabay	Kompositionelles Motiv
Gökduman	Kompositionelles Motiv
Alim	Rufnamenmuster
Noordkamp	Wohnstätte
Droege	Übername
Celiker	Kompositionelles Motiv
Chasanoglou	Rufname
Thönniss	Rufname
Groeber	Wohnstätte
Czeschelski	Beruf
Gonschorowitz	Beruf
Burcak	Rufnamenmuster
Jastrzimski	Herkunft
Eichberg	Herkunft
Gorobez	Beruf
Gallus	Rufname
Kaack	Beruf
Scheifele	Beruf
Basaran	Rufnamenmuster
Alarslan	Kompositionelles Motiv
Leszynski	Herkunft
Akgöl	Kompositionelles Motiv
Putterlik	Übername
Adil	Rufnamenmuster
Schrötke	Übername
Ehrlacher	Herkunft
Sevimli	Rufnamenmuster
Cetintas	Kompositionelles Motiv
Pöhm	Herkunft
Adorf	Herkunft
Lehmair	Beruf
Gencer	Kompositionelles Motiv
Aengenheister	Wohnstätte
Brodski	Herkunft
Oezdogan	Kompositionelles Motiv
Grünspecht	Übername
Hooffacker	Wohnstätte
Mercan	Rufnamenmuster
Yavuzaslan	Kompositionelles Motiv
Sevgi	Rufnamenmuster
Groenefeld	Wohnstätte
Hienz	Rufname
Absmaier	Beruf
Hierlemann	Rufname
Er	Rufnamenmuster
Czerwenka	Beruf
Aykurt	Kompositionelles Motiv
Gaygusuz	Rufnamenmuster
Hilber	Rufname
Karatay	Rufnamenmuster
Gürsoy	Kompositionelles Motiv
Akdas	Kompositionelles Motiv
Kopfmiller	Beruf
Löschner	Übername
Gülpinar	Kompositionelles Motiv
Olejnitzak	Beruf
Kücüker	Kompositionelles Motiv
Bozkurt	Rufnamenmuster
Kubb	Rufname
Lengenfelder	Herkunft
Klepl	Übername
Ackers	Wohnstätte
Grünn	Übername
Lehermaier	Beruf
Oleartschik	Beruf
Canan	Rufnamenmuster
Crusius	Beruf
Niestrath	Wohnstätte
Lescinsky	Herkunft
Nieße	Wohnstätte
Heßenius	Rufname
Griesfeller	Wohnstätte
Yildizbas	Kompositionelles Motiv
Tandogan	Übername
Reipprich	Rufname
Hoogstraat	Wohnstätte
Leszczynska	Herkunft
Pöttinger	Herkunft
Hoppegarten	Wohnstätte
Reiz	Rufname
Aegerter	Herkunft
Heßlein	Rufname
Karaali	Kompositionelles Motiv
Kopmans	Beruf
Arat	Rufnamenmuster
Heße	Rufname
Schrötel	Übername
Koning	Beruf
Akilli	Rufnamenmuster
Grün	Übername
Quasdorf	Herkunft
Cremmer	Beruf
Grüning	Übername
Akduman	Kompositionelles Motiv
Kleu	Übername
Holzkötter	Wohnstätte
Cinkaya	Kompositionelles Motiv
Grünärmel	Übername
Gäbler	Herkunft
Akcetin	Kompositionelles Motiv
Jaszinsky	Herkunft
Christan	Rufname
Tay	Rufnamenmuster
Scheit	Beruf
Heßelmann	Rufname
Lößel	Übername
Horak	Wohnstätte
Gally	Rufname
Jastrzebski	Herkunft
Duber	Übername
Thönnes	Rufname
Abbas	Rufname
Kopfmüller	Beruf
Neuhaus	Herkunft
Solmaz	Rufnamenmuster
Büyükasik	Kompositionelles Motiv
Schukoff	Übername
Catalkaya	Kompositionelles Motiv
Kuhlenkemper	Wohnstätte
Brumby	Herkunft
Süslü	Übername
Dreybrodt	Übername
Abkemeier	Beruf
Kopmann	Beruf
Schrot	Übername
Gümüs	Rufnamenmuster
Büyükkaya	Kompositionelles Motiv
Böger	Wohnstätte
Tasyürek	Rufnamenmuster
Eichwaldt	Herkunft
Reissel	Rufname
Basuslu	Kompositionelles Motiv
Groenegreß	Wohnstätte
Ergüven	Kompositionelles Motiv
Kopfer	Beruf
Gabriels	Rufname
Gültepe	Kompositionelles Motiv
Sivrikaya	Kompositionelles Motiv
Yesilbas	Kompositionelles Motiv
Schuk	Übername
Puszcz	Übername
Gangluff	Rufname
Öner	Kompositionelles Motiv
Güllstorf	Herkunft
Timphus	Wohnstätte
Özaydin	Kompositionelles Motiv
Grönert	Übername
Groenfeldt	Wohnstätte
Kinay	Rufnamenmuster
Löckel	Übername
Cagli	Rufnamenmuster
Köktürk	Kompositionelles Motiv
Kilinc	Rufnamenmuster
Löbl	Übername
Celebioglu	Rufnamenmuster
Krömer	Wohnstätte
Lescinski	Herkunft
Rabenhorst	Herkunft
Olejnick	Beruf
Lehmeyer	Beruf
Cetin	Rufnamenmuster
Cetinkaya	Kompositionelles Motiv
Akpinar	Kompositionelles Motiv
Abdelkarim	Rufname
Lemberger	Herkunft
Justmeyer	Beruf
Heyse	Rufname
Kilickaya	Kompositionelles Motiv
Hilarius	Rufname
Scheidmann	Beruf
Duefel	Übername
Löhser	Übername
Achterfeld	Wohnstätte
Acikelli	Übername
Puntschuh	Übername
Tapper	Übername
Binay	Rufnamenmuster
Hilberth	Rufname
Erkoc	Kompositionelles Motiv
Thüm	Rufname
Eichelsbacher	Herkunft
Tappe	Übername
Holzmann	Wohnstätte
Ptatscheck	Übername
Abbasi	Rufname
Tohmfor	Wohnstätte
Cecen	Rufnamenmuster
Celikel	Kompositionelles Motiv
Thüne	Rufname
Kubiczek	Rufname
Ohlhorn	Beruf
Grünert	Übername
Thänhardt	Rufname
Chasan	Rufname
Absenger	Beruf
Abdullatif	Rufname
Dubenkrop	Übername
Nordbruch	Wohnstätte
Rahmelow	Herkunft
Alacali	Rufnamenmuster
Scheideler	Beruf
Kuhlmann	Wohnstätte
Akbas	Übername
Jastrembski	Herkunft
Pusbatzkis	Übername
Lüdtschwager	Übername
Dubert	Übername
Bruenner	Herkunft
Ablass	Wohnstätte
Neuenkirch	Herkunft
Nurcan	Kompositionelles Motiv
Acher	Wohnstätte
Akalin	Rufnamenmuster
Thönnissen	Rufname
Lehbauer	Beruf
Niggehoff	Wohnstätte
Gorniotzek	Beruf
Jürgenschellert	Beruf
Gang	Rufname
Kubitzka	Rufname
Hilbich	Rufname
Kooper	Beruf
Kursun	Rufnamenmuster
Canoglu	Rufnamenmuster
Lettau	Herkunft
Krumnacker	Wohnstätte
Chimento	Rufname
Neuhauss	Herkunft
Klingshirn	Übername
Gontscharowa	Beruf
Guralzik	Herkunft
Yesilirmak	Kompositionelles Motiv
Ergül	Kompositionelles Motiv
Hilbertz	Rufname
Baysal	Rufnamenmuster
Adeler	Übername
Grünlinger	Übername
Löss	Übername
Düzenli	Rufnamenmuster
Neubacher	Herkunft
Eichenberg	Herkunft
Löwenherz	Übername
Grönig	Übername
Gürcü	Herkunft
Gabriel	Rufname
Gründling	Übername
Aignherr	Übername
Aandekerk	Wohnstätte
Groeneveld	Wohnstätte
Jeschinski	Herkunft
Charcenko	Rufname
Uzuner	Kompositionelles Motiv
Talib	Übername
Kurter	Kompositionelles Motiv
Pöhlmann	Herkunft
Schlieckmann	Wohnstätte
Thönsing	Rufname
Schein	Beruf
Karlidag	Rufnamenmuster
Büche	Wohnstätte
Gültekin	Kompositionelles Motiv
Jüttemeyer	Beruf
Akkilic	Kompositionelles Motiv
Schlipkoeter	Wohnstätte
Sevis	Rufnamenmuster
Norde	Wohnstätte
Lösel	Übername
Merwart	Rufname
Jürgenmeier	Beruf
Gayretli	Rufnamenmuster
Gökalp	Kompositionelles Motiv
Kabakci	Beruf
Dreyßigacker	Übername
Adatepe	Wohnstätte
Olejnikowa	Beruf
Olderog	Beruf
Klingelmann	Übername
Hilbert	Rufname
Jastzembski	Herkunft
Kröhner	Wohnstätte
Kubetzka	Rufname
Abmeyer	Beruf
Jungscholz	Beruf
Cesur	Rufnamenmuster
Quellhorst	Herkunft
Nijlant	Wohnstätte
Cakmak	Rufnamenmuster
Kubetscheck	Rufname
Ecevit	Rufnamenmuster
Gontcharov	Beruf
Bönemann	Wohnstätte
Schuhose	Übername
Ackerknecht	Beruf
Yilmazer	Kompositionelles Motiv
Nonnengess	Wohnstätte
Putze	Übername
Gümüsay	Kompositionelles Motiv
Börnert	Wohnstätte
Ackermann	Beruf
Bati	Rufnamenmuster
Özarslan	Kompositionelles Motiv
Legel	Beruf
Kleinlein	Übername
Klinkfuss	Übername
Gonsiorek	Beruf
Nordkämper	Wohnstätte
Ohliger	Beruf
Thönissen	Rufname
Thönis	Rufname
Ptock	Übername
Thümmes	Rufname
Okuyucu	Beruf
Abele	Rufname
Schleichhardt	Wohnstätte
Adil	Übername
Bedir	Rufnamenmuster
Jasansky	Herkunft
Gündes	Rufnamenmuster
Eichberger	Herkunft
Batmaz	Rufnamenmuster
Krähenbühl	Wohnstätte
Alimoglu	Rufnamenmuster
Abtmeier	Beruf
Grünig	Übername
Kelesoglu	Rufnamenmuster
Tacke	Übername
Kilicarslan	Kompositionelles Motiv
Reinwart	Rufname
Lemmes	Herkunft
Genctürk	Kompositionelles Motiv
Senyurt	Kompositionelles Motiv
Schleichert	Wohnstätte
Serter	Kompositionelles Motiv
Cemil	Rufname
Oleynicki	Beruf
Schlipf	Wohnstätte
Leschinski	Herkunft
Gonsiorczyk	Beruf
Brukmoser	Herkunft
Cesar	Rufname
Krummnack	Wohnstätte
Thébaud	Rufname
Achtzehnter	Übername
Hilaire	Rufname
Kaygisiz	Rufnamenmuster
Adigüzel	Rufnamenmuster
Neuheiser	Herkunft
Schuh	Übername
Lütkevedder	Übername
Pschybilski	Übername
Klinckert	Übername
Schlipköther	Wohnstätte
Emek	Rufnamenmuster
Jasensky	Herkunft
Canli	Rufnamenmuster
Ahlschwedt	Herkunft
Jazinski	Herkunft
Groehn	Wohnstätte
Taenzler	Übername
Kücükaslan	Kompositionelles Motiv
Erol	Rufnamenmuster
Kubicki	Rufname
Mesterharm	Rufname
Abdullah	Rufname
Mert	Rufnamenmuster
Schuckert	Übername
Abdella	Rufname
Klenk	Übername
Scheindlin	Beruf
Kubicka	Rufname
Dude	Übername
Büchle	Wohnstätte
Löseke	Übername
Dudde	Übername
Koopmanns	Beruf
Christel	Rufname
Sengül	Kompositionelles Motiv
Can	Rufnamenmuster
Oleynik	Beruf
Güngör	Rufnamenmuster
Eichelhart	Herkunft
Aaron	Rufname
Akarsu	Rufnamenmuster
Groenenwald	Wohnstätte
Schlichtmann	Wohnstätte
Scheifl	Beruf
Günebakan	Rufnamenmuster
Löwlein	Übername
Nas	Rufnamenmuster
Schugk	Übername
Lacin	Rufnamenmuster
Reipold	Rufname
Reintsema	Rufname
Kibar	Rufnamenmuster
Abtmayr	Beruf
Leeder	Beruf
Cesaro	Rufname
Budak	Rufnamenmuster
Ergin	Rufnamenmuster
Soy	Rufnamenmuster
Gonschorr	Beruf
Böhne	Wohnstätte
Achteresch	Wohnstätte
Göktan	Kompositionelles Motiv
Pützstück	Herkunft
Gencaslan	Kompositionelles Motiv
Gursky	Herkunft
Bilgi	Rufnamenmuster
Bromberger	Herkunft
Grünaug	Übername
Abdulkarim	Rufname
Ptok	Übername
Güneyli	Herkunft
Jasienski	Herkunft
Aslantas	Kompositionelles Motiv
Drenkers	Übername
Schlehmann	Wohnstätte
Pundsack	Übername
Leher	Beruf
Eglofstein	Herkunft
Lengkeit	Herkunft
Grössl	Übername
Durdu	Rufnamenmuster
Battal	Rufnamenmuster
Bozdag	Rufnamenmuster
Güclü	Rufnamenmuster
Scheindl	Beruf
Akbalik	Kompositionelles Motiv
Jastrebski	Herkunft
Klinkertz	Übername
Lessenich	Herkunft
Yesilkaya	Kompositionelles Motiv
Ohlschläger	Beruf
Tasan	Rufnamenmuster
Gangolf	Rufname
Koctürk	Kompositionelles Motiv
Neukirch	Herkunft
Bömkes	Wohnstätte
Eichhorst	Herkunft
Czeike	Beruf
Lesczenski	Herkunft
Gröner	Übername
Mertyn	Rufname
Köksalan	Rufnamenmuster
Chomitsch	Rufname
Gurske	Herkunft
Klingenfuß	Übername
Dreizig	Übername
Uzunay	Kompositionelles Motiv
Cilesiz	Rufnamenmuster
Celikbilek	Rufnamenmuster
Neuerburg	Herkunft
Klinghardt	Übername
Cakirer	Kompositionelles Motiv
Eichholtz	Herkunft
Reize	Rufname
Kubbig	Rufname
Jastremski	Herkunft
Bozyigit	Kompositionelles Motiv
Scheiffele	Beruf
Olejartz	Beruf
Arisoy	Rufnamenmuster
Soydas	Rufnamenmuster
Agri	Herkunft
Aksu	Kompositionelles Motiv
Süß	Übername
Kubatzsch	Rufname
Konink	Beruf
Grünvogel	Übername
Pöppinghaus	Herkunft
Bömke	Wohnstätte
Achtermann	Wohnstätte
Güneysu	Kompositionelles Motiv
Egilmez	Rufnamenmuster
Alp	Rufnamenmuster
Schlicht	Wohnstätte
Christeinicke	Rufname
Hooper	Wohnstätte
Akyüz	Rufnamenmuster
Basegmez	Rufnamenmuster
Lederhos	Beruf
Karabey	Kompositionelles Motiv
Kilicaslan	Kompositionelles Motiv
Acikgöz	Übername
Brozowski	Herkunft
Achberger	Herkunft
Kubicky	Rufname
Kubitzke	Rufname
Kilicli	Rufnamenmuster
Lösser	Übername
Kubbat	Rufname
Jungritter	Beruf
Böhmcker	Wohnstätte
Kleppl	Übername
Görlitzer	Herkunft
Abdulaziz	Rufname
Ach	Wohnstätte
Olejniczak	Beruf
Tanzeglocke	Übername
Broicher	Herkunft
Achten	Wohnstätte
Candemir	Kompositionelles Motiv
Scheidthauer	Beruf
Thänert	Rufname
Thöniß	Rufname
Cetinel	Kompositionelles Motiv
Büyükdag	Rufnamenmuster
Kleylein	Übername
Eglseder	Herkunft
Kuzuoglu	Rufnamenmuster
Cagdas	Rufnamenmuster
Kuhlkamp	Wohnstätte
Aldogan	Kompositionelles Motiv
Böhle	Wohnstätte
Garbode	Rufname
Gökcay	Kompositionelles Motiv
Aycicek	Kompositionelles Motiv
Cubuk	Beruf
Gümüstas	Kompositionelles Motiv
Yildirimer	Kompositionelles Motiv
Bilgic	Rufnamenmuster
Cristal	Beruf
Olejarz	Beruf
Ptatschek	Übername
Schroeck	Übername
Gül	Rufnamenmuster
Jungtorius	Beruf
Topp	Wohnstätte
Eliacik	Rufnamenmuster
Ablaßmayer	Beruf
Niland	Wohnstätte
Jasinsky	Herkunft
Basay	Kompositionelles Motiv
Tanzer	Übername
Koock	Beruf
Lesczynski	Herkunft
Gülbeyaz	Kompositionelles Motiv
Sezer	Rufnamenmuster
Ptascheck	Übername
Kocaslan	Kompositionelles Motiv
Graaf	Beruf
Kleinmann	Übername
Medeni	Rufnamenmuster
Kuhlenkamp	Wohnstätte
Quednow	Herkunft
Yilmaztürk	Kompositionelles Motiv
Griebling	Wohnstätte
Aab	Rufname
Polattimur	Kompositionelles Motiv
Soydan	Rufnamenmuster
Aysel	Kompositionelles Motiv
Lösle	Übername
Achhorner	Wohnstätte
Nergiz	Rufnamenmuster
Kuhlenkampff	Wohnstätte
Yüksekkaya	Kompositionelles Motiv
Schlickers	Wohnstätte
Kubeit	Rufname
Schuettloeffel	Übername
Scheiner	Beruf
Adenauer	Herkunft
Gökkurt	Kompositionelles Motiv
Grünmann	Übername
Kocbay	Kompositionelles Motiv
Akbay	Kompositionelles Motiv
Bruchhoff	Herkunft
Sarialtun	Kompositionelles Motiv
Abbold	Rufname
Dreiwurst	Übername
Aydeniz	Kompositionelles Motiv
Bökenkamp	Wohnstätte
Adlberger	Herkunft
Sertkaya	Kompositionelles Motiv
Arslanbas	Rufnamenmuster
Raffeiner	Herkunft
Dudeck	Übername
Koninkx	Beruf
Reitzle	Rufname
Ohlroggen	Beruf
Kubitzky	Rufname
Erkilinc	Kompositionelles Motiv
Kiziltan	Kompositionelles Motiv
Thönsen	Rufname
Görner	Herkunft
Kubetzek	Rufname
Kirmizitas	Kompositionelles Motiv
Ablassmeier	Beruf
Gortemaker	Beruf
Ari	Rufnamenmuster
Gümüstekin	Kompositionelles Motiv
Nordbroek	Wohnstätte
Gontscharenko	Beruf
Kachelek	Beruf
Sögüt	Rufnamenmuster
Hientz	Rufname
Kubetzki	Rufname
Kulenkampff	Wohnstätte
Tomfelde	Wohnstätte
Jöstingmeier	Beruf
Galletto	Rufname
Cesare	Rufname
Karaboga	Kompositionelles Motiv
Christeiner	Rufname
Kizilyel	Rufnamenmuster
Aigen	Übername
Aslandogan	Kompositionelles Motiv
Asarkaya	Kompositionelles Motiv
Goudsmid	Beruf
Güldal	Rufnamenmuster
Mevs	Rufname
Jägermeyr	Beruf
Cueppers	Beruf
Tippkötter	Wohnstätte
Cagliyan	Rufnamenmuster
Alkis	Rufnamenmuster
Kurtoglu	Rufnamenmuster
Reintzsch	Rufname
Brodskij	Herkunft
Holzkemper	Wohnstätte
Erener	Kompositionelles Motiv
Duddeck	Übername
Jedlitzky	Herkunft
Galletti	Rufname
Mutlu	Rufnamenmuster
Essiz	Rufnamenmuster
Taeubel	Übername
Horacek	Wohnstätte
Cetin	Rufname
Schlipper	Wohnstätte
Gurski	Herkunft
Kleusener	Übername
Duch	Übername
Thölmann	Rufname
Torbecke	Wohnstätte
Sevindi	Rufnamenmuster
Duehrkoop	Übername
Ceylan	Rufnamenmuster
Jaworska	Herkunft
Kilincarslan	Kompositionelles Motiv
Grünling	Übername
Baydemir	Kompositionelles Motiv
Abramsky	Herkunft
Adamczewska	Herkunft
Okumus	Rufnamenmuster
Ergezer	Kompositionelles Motiv
Pölmann	Herkunft
Lescinskas	Herkunft
Dube	Übername
Oksenhirdt	Beruf
Achtzehner	Übername
Hoppmanns	Wohnstätte
Uslubas	Kompositionelles Motiv
Thöns	Rufname
Noordmann	Wohnstätte
Kleinsorg	Übername
Göktas	Kompositionelles Motiv
Kayabasi	Rufnamenmuster
Koperschmidt	Beruf
Jedamowski	Herkunft
Bömcke	Wohnstätte
Durna	Rufnamenmuster
Griebner	Wohnstätte
Sener	Kompositionelles Motiv
Cuper	Beruf
Olejnik	Beruf
Abkemeyer	Beruf
Kabel	Beruf
Gonschor	Beruf
Heß	Rufname
Meven	Rufname
Jastschemski	Herkunft
Lenkait	Herkunft
Süssel	Übername
Christa	Rufname
Kayalar	Rufnamenmuster
Candan	Rufnamenmuster
Kubecek	Rufname
Reisle	Rufname
Olejar	Beruf
Adamczewski	Herkunft
Christe	Rufname
Lössle	Übername
Löscher	Übername
Ehrenberger	Herkunft
Konwischer	Beruf
Ptaschek	Übername
Grünler	Übername
Hopfengärtner	Wohnstätte
Drüge	Übername
Chartschenko	Rufname
Tomfeld	Wohnstätte
Jaszinski	Herkunft
Jesberg	Herkunft
Jägerbauer	Beruf
Gangolff	Rufname
Süßle	Übername
Kockaya	Kompositionelles Motiv
Nordmann	Wohnstätte
Kuvvetli	Rufnamenmuster
Beytas	Kompositionelles Motiv
Kruthof	Wohnstätte
Metze	Rufname
Reisel	Rufname
Mewes	Rufname
Drenker	Übername
Pöhler	Herkunft
Keskinkilic	Rufnamenmuster
Kroonen	Wohnstätte
Achterfeldt	Wohnstätte
Bozdogan	Kompositionelles Motiv
Sevim	Rufnamenmuster
Mewen	Rufname
Akbudak	Kompositionelles Motiv
Ulutürk	Kompositionelles Motiv
Ptaszek	Übername
Cicek	Rufnamenmuster
Leffler	Beruf
Gaiss	Rufname
Garbert	Rufname
Celikkol	Rufnamenmuster
Jastrzembskis	Herkunft
Culhaci	Beruf
Bulut	Rufnamenmuster
Nergis	Rufnamenmuster
Caglayan	Rufnamenmuster
Sengün	Kompositionelles Motiv
Dreißgacker	Übername
Puschamsies	Übername
Kroon	Wohnstätte
Scheitl	Beruf
Adenäuer	Herkunft
Krumin	Wohnstätte
Kubica	Rufname
Adamschewski	Herkunft
Özcakir	Kompositionelles Motiv
Hoppenworth	Wohnstätte
Hilbrans	Rufname
Karakis	Rufnamenmuster
Guggomos	Herkunft
Jeblonski	Herkunft
Konukcu	Beruf
Pschorr	Übername
Sarican	Kompositionelles Motiv
Holzkämpfer	Wohnstätte
Adamskie	Herkunft
Sevda	Rufnamenmuster
Koppermann	Beruf
Ahlschwede	Herkunft
Olejnikov	Beruf
Scheike	Beruf
Christeit	Rufname
Bruckmoser	Herkunft
Atabay	Kompositionelles Motiv
Krumenacker	Wohnstätte
Bilgili	Rufnamenmuster
Schuele	Übername
Haagmann	Herkunft
Gabrieljürgens	Rufname
Puszczewicz	Übername
Abdel-Karim	Rufname
Gülcan	Kompositionelles Motiv
Klingenspor	Übername
Gontscharov	Beruf
Adamowski	Herkunft
Puppe	Übername
Abmayr	Beruf
Pusamßies	Übername
Achtner	Übername
Lößer	Übername
Schliecker	Wohnstätte
Holzmanns	Wohnstätte
Kulenkampf	Wohnstätte
Esgin	Rufnamenmuster
Kuhberg	Wohnstätte
Kubitzki	Rufname
Brueckmann	Herkunft
Hopfgarten	Wohnstätte
Neuhof	Herkunft
Mesterjahn	Rufname
Mavicicek	Kompositionelles Motiv
Ohlig	Beruf
Christann	Rufname
Krönlein	Wohnstätte
Kaplaner	Kompositionelles Motiv
Ablaß	Wohnstätte
Göksen	Kompositionelles Motiv
Brosowski	Herkunft
Brosowsky	Herkunft
Büchel	Wohnstätte
Abbetmeyer	Beruf
Grinbergs	Wohnstätte
Abbink	Rufname
Boyraz	Rufnamenmuster
Mermeroglu	Rufnamenmuster
Czeschelsky	Beruf
Yildizhan	Kompositionelles Motiv
Erden	Rufnamenmuster
Kaya	Rufnamenmuster
Gülsdorff	Herkunft
Lösl	Übername
Czayka	Beruf
Schuelein	Übername
Krumm	Wohnstätte
Thümmel	Rufname
Schleifmann	Wohnstätte
Reipert	Rufname
Tac	Rufnamenmuster
Görlinger	Herkunft
Klingenfuss	Übername
Reiprich	Rufname
Jöstingmeyer	Beruf
Neuhäußer	Herkunft
Kutlu	Rufnamenmuster
Alatas	Kompositionelles Motiv
Gais	Rufname
Adler	Übername
Kubetat	Rufname
Scheidmeyer	Beruf
Brumbi	Herkunft
Reizlein	Rufname
Gönnheimer	Herkunft
Göktepe	Herkunft
Löbsack	Übername
Sürmeli	Übername
Dubenkropp	Übername
Akdogan	Rufnamenmuster
Bökenheide	Wohnstätte
Nobis	Wohnstätte
Achtel	Übername
Advena	Übername
Reintjes	Rufname
Gröne	Übername
Reiß	Rufname
Eichholz	Herkunft
Puszamszies	Übername
Durur	Rufnamenmuster
Akpolat	Kompositionelles Motiv
Reis	Rufname
Hoppenheidt	Wohnstätte
Gonschoreck	Beruf
Nordholz	Wohnstätte
Graafen	Beruf
Scheiffelen	Beruf
Ehrbächer	Herkunft
Ohligschläger	Beruf
Abdalrahman	Rufname
Acar	Übername
Nordenholz	Wohnstätte
Koper	Beruf
Böhmker	Wohnstätte
Özbolat	Kompositionelles Motiv
Sevinc	Rufnamenmuster
Eichholdtz	Herkunft
Kachelmus	Beruf
Raffelsberger	Herkunft
Sencan	Kompositionelles Motiv
Lüttjemann	Übername
Gün	Rufnamenmuster
Candas	Rufnamenmuster
Gorobec	Beruf
Holzweger	Wohnstätte
Cemal	Rufname
Kuil	Wohnstätte
Bereket	Rufnamenmuster
Aign	Übername
Nordholt	Wohnstätte
Gontcharova	Beruf
Konwisarz	Beruf
Tasar	Rufnamenmuster
Klemm	Übername
Hierlmann	Rufname
Günzkofer	Herkunft
Akyigit	Kompositionelles Motiv
Adamovskyy	Herkunft
Groenendal	Wohnstätte
Gröhn	Übername
Gröning	Übername
Gülstorp	Herkunft
Dreyssigacker	Übername
Efe	Rufnamenmuster
Schukov	Übername
Eichelhardt	Herkunft
Löblein	Übername
Böke	Wohnstätte
Cesario	Rufname
Leitner	Herkunft
Nordhoff	Wohnstätte
Leschensky	Herkunft
Akcan	Kompositionelles Motiv
Gonzoreck	Beruf
Achtert	Übername
Abmaier	Beruf
Tombach	Wohnstätte
Ehrich	Herkunft
Guggumos	Herkunft
Püringer	Herkunft
Goudsmit	Beruf
Garbers	Rufname
Schlickmann	Wohnstätte
Kubiack	Rufname
Neudorfer	Herkunft
Puskeppeleit	Übername
Talebizadeh	Übername
Aktoprak	Kompositionelles Motiv
Krumins	Wohnstätte
Abderrahman	Rufname
Lundgreen	Kompositionelles Motiv
Bruchhausen	Herkunft
Gutzentat	Herkunft
Kutay	Kompositionelles Motiv
Thöling	Rufname
Christahn	Rufname
Adomowski	Herkunft
Karaalp	Kompositionelles Motiv
Aengenheyster	Wohnstätte
Görsdorf	Herkunft
Scheitterer	Beruf
Ehricht	Herkunft
Gurskij	Herkunft
Jasinska	Herkunft
Arslantürk	Kompositionelles Motiv
Ptack	Übername
Klingspor	Übername
Ohlschlägel	Beruf
Olejarova	Beruf
Merwarth	Rufname
Christelsohn	Rufname
Jungweber	Beruf
Akdag	Rufnamenmuster
Gaebelt	Rufname
Güntürk	Kompositionelles Motiv
Konincks	Beruf
Konwissorz	Beruf
Ak	Rufnamenmuster
Kilickeser	Rufnamenmuster
Schlitzer	Wohnstätte
Schlele	Wohnstätte
Böhler	Wohnstätte
Aktay	Rufnamenmuster
Lösslin	Übername
Mertoglu	Rufnamenmuster
Brucker	Herkunft
Ada	Wohnstätte
Guralczyk	Herkunft
Torbeck	Wohnstätte
Canpolat	Kompositionelles Motiv
Abdulkadir	Rufname
Brokhausen	Herkunft
Grieblinger	Wohnstätte
Kubig	Rufname
Ackerbauer	Beruf
Groener	Wohnstätte
Ulutas	Kompositionelles Motiv
Cruse	Beruf
Konwisorz	Beruf
Holzkamp	Wohnstätte
Abdelrahman	Rufname
Heynsen	Rufname
Kandemir	Kompositionelles Motiv
Kir	Rufnamenmuster
Abtmeyer	Beruf
Sahinkaya	Kompositionelles Motiv
Chlaß	Rufname
Taenzer	Übername
Dreißig	Übername
Leermann	Beruf
Reissen	Rufname
Ayer	Kompositionelles Motiv
Gröber	Übername
Duygu	Rufnamenmuster
Adscheid	Herkunft
Egloffstein	Herkunft
Götzinger	Herkunft
Erkilic	Kompositionelles Motiv
Jägermair	Beruf
Akarcay	Rufnamenmuster
Erdönmez	Kompositionelles Motiv
Nijland	Wohnstätte
Scheidmiller	Beruf
Thöne	Rufname
Eichenauer	Herkunft
Klinkert	Übername
Göksungur	Kompositionelles Motiv
Leschzenski	Herkunft
Civelek	Rufnamenmuster
Cinar	Rufnamenmuster
Reitzer	Rufname
Sarpkaya	Kompositionelles Motiv
Achterberg	Wohnstätte
Durcan	Rufnamenmuster
Neuenhausen	Herkunft
Kopfermann	Beruf
Hierold	Rufname
Jasinski	Herkunft
Christansen	Rufname
Kubocz	Rufname
Lesczensky	Herkunft
Bastug	Kompositionelles Motiv
Kulenkamff	Wohnstätte
Jastrzembsky	Herkunft
Hoppmann	Wohnstätte
Basyigit	Kompositionelles Motiv
Cakaloglu	Rufnamenmuster
Achterkerke	Wohnstätte
Bektas	Rufnamenmuster
Reizele	Rufname
Ferah	Rufnamenmuster
Gaeble	Rufname
Metten	Rufname
Achen	Herkunft
Lenkheit	Herkunft
Bilge	Rufnamenmuster
Mewis	Rufname
Thün	Rufname
Tistel	Wohnstätte
Thönes	Rufname
Schrümpf	Übername
Thönißen	Rufname
Leszinski	Herkunft
Thönnehsen	Rufname
Kubiza	Rufname
Güney	Rufnamenmuster
Neufelder	Herkunft
Schleicher	Wohnstätte
Gaise	Rufname
Kabernagel	Beruf
Schlemann	Wohnstätte
Neuhofer	Herkunft
Czaika	Beruf
Kusoglu	Rufnamenmuster
Ertem	Rufnamenmuster
Gözen	Rufnamenmuster
Ptoszek	Übername
Kopperschlaeger	Beruf
Ackerer	Beruf
Olgun	Rufnamenmuster
Custer	Beruf
Schu	Übername
Gamal	Rufname
Griepp	Wohnstätte
Neuhauser	Herkunft
Hopfgart	Wohnstätte
Adamske	Herkunft
Kruming	Wohnstätte
Norden	Wohnstätte
Tistler	Wohnstätte
Aarns	Rufname
Bömker	Wohnstätte
Adamski	Herkunft
Bömken	Wohnstätte
Leupolz	Herkunft
Düzgün	Rufnamenmuster
Kubbutat	Rufname
Aygül	Kompositionelles Motiv
Kuehnast	Wohnstätte
Uzunkaya	Kompositionelles Motiv
Gallaher	Rufname
Puskeppel	Übername
Hieronymi	Rufname
Duddek	Übername
Gottsacker	Beruf
Scheitmann	Beruf
Quellen	Herkunft
Christeleit	Rufname
Scheidter	Beruf
Dreissigacker	Übername
Größl	Übername
Nuray	Rufnamenmuster
Achtmann	Beruf
Neuenkirchen	Herkunft
Gündog	Rufnamenmuster
Reizel	Rufname
Schlickhoff	Wohnstätte
Abe	Rufname
Lehmayr	Beruf
Abdulrahman	Rufname
Eicholz	Herkunft
Caylak	Rufnamenmuster
Bruggmoser	Herkunft
Grünaugl	Übername
Böhmcke	Wohnstätte
Lembeck	Herkunft
Yücetas	Kompositionelles Motiv
Schleipfer	Wohnstätte
Koppelmeier	Beruf
Karaaslan	Kompositionelles Motiv
Druckenbrod	Übername
Groenveld	Wohnstätte
Abas	Rufname
Klepel	Übername
Quiadkowsky	Herkunft
Mermertas	Rufnamenmuster
Lehermeier	Beruf
Lehert	Beruf
Acht	Übername
Galles	Rufname
Kopperschläger	Beruf
Aykoc	Kompositionelles Motiv
Schliekert	Wohnstätte
Ackers	Beruf
Ahnesorg	Übername
Reipricht	Rufname
Bayir	Rufnamenmuster
Quädnau	Herkunft
Mettag	Rufname
Dubon	Übername
Schuettpelz	Übername
Eichenberger	Herkunft
Netzbandt	Herkunft
Klingfuss	Übername
Acker	Beruf
Erdem	Rufnamenmuster
Puce	Übername
Timmerhuis	Wohnstätte
Özbakir	Kompositionelles Motiv
Kubo	Rufname
Karababa	Kompositionelles Motiv
Eskin	Rufnamenmuster
Celikkiran	Rufnamenmuster
Kocakaya	Kompositionelles Motiv
Torhorst	Wohnstätte
Gönen	Rufnamenmuster
Thönßen	Rufname
Klingkert	Übername
Gönültas	Rufnamenmuster
Mevissen	Rufname
Abbt	Übername
Kanyilmaz	Kompositionelles Motiv
Reizle	Rufname
Ackern	Wohnstätte
Schrötl	Übername
Torheyden	Wohnstätte
Cetinbag	Kompositionelles Motiv
Gökbayrak	Kompositionelles Motiv
Armagan	Rufnamenmuster
Schrötgens	Übername
Holzkampf	Wohnstätte
Scheindel	Beruf
Löwe	Übername
Ceviker	Kompositionelles Motiv
Brugmoser	Herkunft
Cetinbas	Kompositionelles Motiv
Arslan	Rufnamenmuster
Culcu	Beruf
Netzebandt	Herkunft
Schroetgens	Übername
Leschzinsky	Herkunft
Karabel	Kompositionelles Motiv
Gurska	Herkunft
Özcelik	Kompositionelles Motiv
Eicholzer	Herkunft
Schleipfner	Wohnstätte
Gülsdorf	Herkunft
Menekse	Rufnamenmuster
Neuenhofer	Herkunft
Czerwinka	Beruf
Reintke	Rufname
Pucala	Übername
Gaebel	Rufname
Puff	Übername
Pschribülla	Übername
Tappen	Übername
Börner	Wohnstätte
Cuepper	Beruf
Aydiner	Kompositionelles Motiv
Algan	Rufnamenmuster
Nordhold	Wohnstätte
Erduran	Kompositionelles Motiv
Achternkamp	Wohnstätte
Reitzlein	Rufname
Krumnack	Wohnstätte
Achermann	Beruf
Ehlscheidt	Herkunft
Rambow	Herkunft
Kücüktas	Kompositionelles Motiv
Korkmazer	Kompositionelles Motiv
Sönmez	Rufnamenmuster
Pöhlert	Herkunft
Gökcan	Kompositionelles Motiv
Neudoerfer	Herkunft
Reinwarth	Rufname
Quelle	Herkunft
Heyns	Rufname
Grohne	Wohnstätte
Scheithauer	Beruf
Ptak	Übername
Köksal	Rufnamenmuster
Durmusoglu	Rufnamenmuster
Schlipköter	Wohnstätte
Schlicker	Wohnstätte
Bastürk	Kompositionelles Motiv
Putter	Übername
Sevindik	Rufnamenmuster
Aslandag	Kompositionelles Motiv
Ardic	Rufnamenmuster
Gök	Rufnamenmuster
Kurun	Rufnamenmuster
Sonkaya	Kompositionelles Motiv
Rafflenbeul	Herkunft
Gall	Rufname
Scheidtmann	Beruf
Reinwaldt	Rufname
Aelter	Übername
Jasmund	Herkunft
Nonnengässer	Wohnstätte
Jastrzembski	Herkunft
Gräul	Übername
Özavci	Kompositionelles Motiv
Raffl	Herkunft
Niggeloh	Wohnstätte
Aarents	Rufname
Klespies	Übername
Garbracht	Rufname
Achterhuis	Wohnstätte
Timmerscheidt	Wohnstätte
Keklik	Rufnamenmuster
Schlitz	Wohnstätte
Hilbrand	Rufname
Isiktas	Kompositionelles Motiv
Neuhauß	Herkunft
Akkoyun	Kompositionelles Motiv
Süßl	Übername
Güler	Rufnamenmuster
Reisz	Rufname
Lefeber	Beruf
Olearczyk	Beruf
Brokhaus	Herkunft
Schroeckel	Übername
Neuenhöfer	Herkunft
Chomenko	Rufname
Jägerhuber	Beruf
Meuwssen	Rufname
Honacker	Wohnstätte
Dreyzehner	Übername
Gülay	Kompositionelles Motiv
Lehe	Beruf
Süssmilch	Übername
Neudörffer	Herkunft
Meuwsen	Rufname
Özaslan	Kompositionelles Motiv
tom Wörden	Wohnstätte
Schroetke	Übername
Serttas	Rufnamenmuster
Thönert	Rufname
Lehmler	Beruf
Schrumpf	Übername
Bruhne	Herkunft
Griebler	Wohnstätte
Ptaczek	Übername
Reinwald	Rufname
Groenhof	Wohnstätte
Lößlin	Übername
Klingenspohr	Übername
Celikkaya	Kompositionelles Motiv
Balkaya	Kompositionelles Motiv
Beyazgül	Kompositionelles Motiv
Taskiran	Rufnamenmuster
Arslancan	Rufnamenmuster
Christandl	Rufname
Aengeneyndt	Wohnstätte
Böhmeke	Wohnstätte
Bösveld	Wohnstätte
Sariyildiz	Kompositionelles Motiv
Eichelhard	Herkunft
Schukalla	Übername
Jungschlaeger	Beruf
Metz	Rufname
Cesari	Rufname
Berktas	Kompositionelles Motiv
Koopman	Beruf
Rahmstorf	Herkunft
Klinkhard	Übername
Scheinert	Beruf
Leschinsky	Herkunft
Görmar	Herkunft
Kuvvet	Rufnamenmuster
Kirmizi	Rufnamenmuster
Schröttel	Übername
Kook	Beruf
Süssle	Übername
Grünitz	Übername
Torheiden	Wohnstätte
Büchelin	Wohnstätte
Nord	Wohnstätte
Leerhuber	Beruf
Lehmann	Beruf
Cihan	Rufnamenmuster
Berkcan	Kompositionelles Motiv
Kool	Beruf
Eryilmaz	Kompositionelles Motiv
Böckmann	Wohnstätte
Kröner	Wohnstätte
Tomberg	Wohnstätte
Kleissner	Übername
Görgü	Rufnamenmuster
Czermak	Beruf
Gooßmann	Beruf
Acht	Beruf
Tanzeglock	Übername
Schlieker	Wohnstätte
Dudek	Übername
Sarier	Kompositionelles Motiv
Haag	Herkunft
Legl	Beruf
Kubik	Rufname
Gröhne	Übername
Hoppenbrink	Wohnstätte
Eichmann	Herkunft
Neuhausen	Herkunft
Drollmann	Übername
Mette	Rufname
Schlikker	Wohnstätte
Kabelmann	Beruf
Günay	Kompositionelles Motiv
Lößl	Übername
Cankur	Rufnamenmuster
Senyildiz	Kompositionelles Motiv
Evren	Rufnamenmuster
Leszczensky	Herkunft
Kliebenschedel	Übername
Sevilmis	Rufnamenmuster
Elmas	Rufnamenmuster
Eichelsdörfer	Herkunft
Schlichter	Wohnstätte
Oldermann	Beruf
Arslanoglu	Rufnamenmuster
Teke	Rufnamenmuster
Ergün	Kompositionelles Motiv
Sarialtin	Kompositionelles Motiv
Jastrimski	Herkunft
Yücebas	Kompositionelles Motiv
Grieskamp	Wohnstätte
Kuehberger	Wohnstätte
Abbott	Übername
Gornik	Beruf
Ledergerber	Beruf
Koop	Beruf
Baykara	Kompositionelles Motiv
Sahiner	Kompositionelles Motiv
Cananoglu	Rufnamenmuster
Cuyper	Beruf
Drolle	Übername
Birinci	Rufnamenmuster
Heyntz	Rufname
Ablas	Wohnstätte
Gülsoy	Kompositionelles Motiv
Czajka	Beruf
Tantz	Übername
Akar	Rufnamenmuster
Schlelein	Wohnstätte
Eski	Rufnamenmuster
Gökdemir	Kompositionelles Motiv
Gündogar	Rufnamenmuster
Grohn	Wohnstätte
Schromm	Übername
Adsiz	Übername
Mewissen	Rufname
Aal	Wohnstätte
Hielbig	Rufname
Agirbas	Übername
Hoppenkamps	Wohnstätte
Puskeppelies	Übername
Dumanoglu	Rufnamenmuster
Scheitel	Beruf
Konwisorsch	Beruf
Brodskyy	Herkunft
Neuenhofen	Herkunft
Kutay	Rufnamenmuster
Nonnengäßer	Wohnstätte
Acartürk	Kompositionelles Motiv
Jüttemeier	Beruf
Cromer	Beruf
Ptoschek	Übername
Kubiak	Rufname
Koc	Rufnamenmuster
Erat	Rufnamenmuster
Kutlucan	Rufnamenmuster
Hilberts	Rufname
Lehenherr	Beruf
Kuhle	Wohnstätte
Uzunel	Kompositionelles Motiv
Bülbül	Rufnamenmuster
Akay	Kompositionelles Motiv
Schroettle	Übername
Schrott	Übername
Grünemann	Übername
Leißner	Herkunft
Achmann	Wohnstätte
Tombrink	Wohnstätte
Neudorf	Herkunft
Grön	Übername
Adamovsky	Herkunft
Özcetin	Kompositionelles Motiv
Bolat	Rufnamenmuster
Kachelmuss	Beruf
Nordloh	Wohnstätte
Schukow	Übername
Aestel	Übername
Emeksiz	Rufnamenmuster
Radensleben	Herkunft
Süss	Übername
Gründl	Übername
Kuhl	Wohnstätte
Jedamski	Herkunft
Klemme	Übername
Groenebaum	Wohnstätte
Ackert	Wohnstätte
Ackermans	Beruf
Taeubert	Übername
Dröge	Übername
Bilen	Rufnamenmuster
Akkoca	Kompositionelles Motiv
Tasgin	Rufnamenmuster
Schlehöfer	Wohnstätte
Bakirtas	Kompositionelles Motiv
Ergenc	Kompositionelles Motiv
Süßmilch	Übername
Schleif	Wohnstätte
Scheide	Beruf
Eichendorff	Herkunft
Groenewegen	Wohnstätte
Meuwßen	Rufname
Schroetel	Übername
Gaebert	Rufname
Lesszinsky	Herkunft
Groenevelt	Wohnstätte
Grohnwaldt	Wohnstätte
Adamowska	Herkunft
Thönges	Rufname
Ayhan	Kompositionelles Motiv
Lederhas	Beruf
Groeneweg	Wohnstätte
Olearius	Beruf
Lengefeld	Herkunft
Culha	Beruf
Achtert	Beruf
Canbulat	Kompositionelles Motiv
Broscheid	Herkunft
Adebar	Übername
Chlaußen	Rufname
Güldali	Rufnamenmuster
Raimann	Herkunft
Bökers	Wohnstätte
Gökoglu	Rufnamenmuster
Gries	Wohnstätte
Gopfauf	Beruf
Olejars	Beruf
Ada	Rufnamenmuster
Kleisner	Übername
Nootenboom	Wohnstätte
Scheiterle	Beruf
Kaakschlief	Beruf
Javorski	Herkunft
Leesmeister	Beruf
Heßelink	Rufname
Özay	Kompositionelles Motiv
Lefebre	Beruf
Schukalski	Übername
Kubiczeck	Rufname
Neukirchen	Herkunft
Kizilkaya	Kompositionelles Motiv
Galle	Rufname
Güneser	Kompositionelles Motiv
Kolay	Rufnamenmuster
Mews	Rufname
Kleusner	Übername
Klingsporn	Übername
Heynz	Rufname
Jürgensmeyer	Beruf
Gökce	Herkunft
Lefeuvre	Beruf
Saricicek	Kompositionelles Motiv
Kopec	Beruf
Gonschorreck	Beruf
Jürgensmeier	Beruf
Leschner	Herkunft
Schlik	Wohnstätte
Efendi	Rufnamenmuster
Lekesiz	Rufnamenmuster
Tophof	Wohnstätte
Hopen	Wohnstätte
Thönnessen	Rufname
Tippkoetter	Wohnstätte
Schrämli	Übername
Schlieck	Wohnstätte
Acikelli	Rufnamenmuster
Adatepe	Herkunft
Kruhming	Wohnstätte
Bilim	Rufnamenmuster
Karabeyaz	Kompositionelles Motiv
Kubbetat	Rufname
Goos	Beruf
Dreyßig	Übername
Sevgili	Rufnamenmuster
Süssl	Übername
Eichendorf	Herkunft
Eichwalder	Herkunft
Ulusan	Kompositionelles Motiv
Soysal	Rufnamenmuster
Süssemilch	Übername
Thönneßen	Rufname
Leszinsky	Herkunft
Basoglu	Rufnamenmuster
Acikgöz	Rufnamenmuster
Ohlenschläger	Beruf
Ohlrogge	Beruf
Adorff	Herkunft
Meyborg	Rufname
Jungschmidt	Beruf
Mevius	Rufname
Durmaz	Rufnamenmuster
Lößle	Übername
Guggenmos	Herkunft
Brodskaia	Herkunft
Neuhoefer	Herkunft
Lederhose	Beruf
Adamska	Herkunft
Kocaer	Kompositionelles Motiv
Eichinger	Herkunft
Crueger	Beruf
Grühn	Übername
Taylan	Rufnamenmuster
Olbeter	Beruf
Grois	Wohnstätte
Metaschk	Rufname
Aytekin	Kompositionelles Motiv
Kayaoglu	Rufnamenmuster
Eyidogan	Rufnamenmuster
Tombrinck	Wohnstätte
Scheidler	Beruf
Aigenherr	Übername
Eich	Herkunft
Aevern	Herkunft
Kizil	Rufnamenmuster
Abdalla	Rufname
Kubecka	Rufname
Guggenmoos	Herkunft
Puffpaff	Übername
tom Felde	Wohnstätte
Horack	Wohnstätte
Adiyaman	Übername
Gornick	Beruf
Kirci	Rufnamenmuster
Lenkajtis	Herkunft
Abbenzeller	Herkunft
Thöniss	Rufname
Brokhof	Herkunft
Ersoy	Kompositionelles Motiv
Kubigk	Rufname
Atlihan	Kompositionelles Motiv
Adiyaman	Herkunft
Pucalla	Übername
Akyurt	Kompositionelles Motiv
Ohlrogg	Beruf
Lösken	Übername
Kiran	Rufnamenmuster
Schrötlin	Übername
Charitius	Rufname
Yenidogan	Kompositionelles Motiv
Gülbahce	Rufnamenmuster
Quint	Herkunft
Löslein	Übername
Dreizehner	Übername
Jaworski	Herkunft
Büchlein	Wohnstätte
Toepp	Wohnstätte
Köklü	Rufnamenmuster
Gräbing	Übername
Neuendorff	Herkunft
Gorniok	Beruf
Gafel	Rufname
Akbayir	Kompositionelles Motiv
Gönül	Rufnamenmuster
Löcklin	Übername
Thöws	Rufname
Duygulu	Rufnamenmuster
Leschzensky	Herkunft
Reinwardt	Rufname
Kabak	Beruf
Akyildiz	Kompositionelles Motiv
Cetinalp	Kompositionelles Motiv
Grönn	Übername
Gümüssoy	Kompositionelles Motiv
Thübel	Rufname
Akbaba	Rufnamenmuster
Klinkerfuß	Übername
Drillhose	Übername
Reitzner	Rufname
Gonserkewitz	Beruf
Leszczynski	Herkunft
Böhl	Wohnstätte
Heßelmans	Rufname
Neudorff	Herkunft
Hiermann	Rufname
Griesfelder	Wohnstätte
Neuffer	Herkunft
Metasch	Rufname
Schlich	Wohnstätte
Cenek	Rufname
Pühlhöfer	Herkunft
Yesilöz	Kompositionelles Motiv
Achleitner	Herkunft
Absmeier	Beruf
Cam	Rufnamenmuster
Büyük	Rufnamenmuster
Bilican	Rufnamenmuster
Abbrecht	Rufname
Nettesheim	Herkunft
Aidam	Übername
Beker	Rufnamenmuster
Größle	Übername
Pekdemir	Kompositionelles Motiv
Aydogan	Kompositionelles Motiv
Agac	Rufnamenmuster
Aigner	Übername
Sevket	Rufnamenmuster
Achter	Übername
Ergen	Rufnamenmuster
Gröbert	Übername
Noeckel	Wohnstätte
Kök	Rufnamenmuster
Schuck	Übername
Afacan	Übername
Kücükkaya	Kompositionelles Motiv
Kacheleck	Beruf
Quiatkowsky	Herkunft
Löble	Übername
Lederer	Beruf
Kuhberger	Wohnstätte
Ohlrog	Beruf
Kopman	Beruf
Aktürk	Kompositionelles Motiv
Olejok	Beruf
Gural	Herkunft
Gammel	Rufname
Ohligs	Beruf
Cantürk	Kompositionelles Motiv
Akbas	Rufnamenmuster
Batur	Rufnamenmuster
Saridogan	Kompositionelles Motiv
Kocaaslan	Kompositionelles Motiv
Nordholtz	Wohnstätte
Scheiderer	Beruf
Cuwalsky	Beruf
Alaca	Rufnamenmuster
Löwenhaupt	Übername
Tombült	Wohnstätte
Kücükal	Kompositionelles Motiv
Aydindag	Kompositionelles Motiv
Kiziler	Kompositionelles Motiv
Tinnemann	Wohnstätte
Cruße	Beruf
Düzen	Rufnamenmuster
Akyol	Kompositionelles Motiv
Kopmeier	Beruf
Thyssens	Rufname
Neudeck	Herkunft
Durmus	Rufnamenmuster
Reinwein	Rufname
Quednau	Herkunft
Karaahmet	Kompositionelles Motiv
Ablaßmeir	Beruf
Lefèvre	Beruf
Aygün	Kompositionelles Motiv
Adebahr	Übername
Koopers	Beruf
Achtermeyer	Beruf
Quosdorf	Herkunft
Basar	Rufnamenmuster
Nijhoff	Wohnstätte
Ertekin	Kompositionelles Motiv
Niggebruegge	Wohnstätte
Thönnihsen	Rufname
Gülüm	Rufnamenmuster
Akbiyik	Übername
Nordbrink	Wohnstätte
Gülbas	Kompositionelles Motiv
Hoopmann	Wohnstätte
Kleinsorge	Übername
Hopmann	Wohnstätte
Celikbilek	Kompositionelles Motiv
Filiz	Rufnamenmuster
Pühringer	Herkunft
Kaak	Beruf
Holzkämper	Wohnstätte
Mewing	Rufname
Beydemir	Kompositionelles Motiv
Akcakaya	Kompositionelles Motiv
Lefebvre	Beruf
Baspinar	Kompositionelles Motiv
Kirdemir	Kompositionelles Motiv
Konings	Beruf
Klingfuß	Übername
Christans	Rufname
Scheitle	Beruf
Homann	Wohnstätte
Lederhaas	Beruf
Groenhagen	Wohnstätte
Cansu	Kompositionelles Motiv
Ok	Rufnamenmuster
Fidan	Rufnamenmuster
Boztepe	Kompositionelles Motiv
Civan	Rufnamenmuster
Nobes	Wohnstätte
Metzlaff	Rufname
Ablaßmaier	Beruf
Seref	Rufnamenmuster
Sengezer	Kompositionelles Motiv
Köken	Rufnamenmuster
Jungrichter	Beruf
Rammrath	Herkunft
Drinkhuth	Übername
Kubitschek	Rufname
Acar	Herkunft
Dreyheller	Übername
Olejnicek	Beruf
Nikkel	Wohnstätte
Haspolat	Kompositionelles Motiv
Bökamp	Wohnstätte
Küpelikilinc	Kompositionelles Motiv
Kopetz	Beruf
Mermer	Rufnamenmuster
Jestrembski	Herkunft
Okur	Rufnamenmuster
Brombach	Herkunft
Groenen	Wohnstätte
Schrötges	Übername
Aytemur	Kompositionelles Motiv
Jestremski	Herkunft
Akin	Rufnamenmuster
Eicher	Herkunft
Griep	Wohnstätte
Nordemann	Wohnstätte
Jeddeloh	Herkunft
Cesareo	Rufname
Scheika	Beruf
Brok	Herkunft
Abali	Übername
Hoppenbrock	Wohnstätte
Ohlmüller	Beruf
Hilbrands	Rufname
Hilberer	Rufname
Gaebhard	Rufname
Taentzler	Übername
Kizildag	Rufnamenmuster
Achenbach	Herkunft
Dreyhsig	Übername
Scheifel	Beruf
Cremerius	Beruf
Neudegger	Herkunft
Abbes	Rufname
Pufpaff	Übername
Achtzehn	Übername
Lehder	Beruf
Neuhöfer	Herkunft
Güneysu	Rufnamenmuster
Abdellatif	Rufname
Achtziger	Übername
Czeschla	Beruf
Gonsior	Beruf
Bayar	Rufnamenmuster
Schliekmann	Wohnstätte
Koops	Beruf
Aktepe	Kompositionelles Motiv
Adali	Wohnstätte
Gorniatzek	Beruf
Esen	Rufnamenmuster
Tas	Rufnamenmuster
Niestradt	Wohnstätte
Ablaßmeier	Beruf
Thömmes	Rufname
Grünlings	Übername
Kopez	Beruf
Hilbig	Rufname
Abdelhamid	Rufname
Klinghart	Übername
Göhring	Herkunft
Absmayer	Beruf
Groenendaal	Wohnstätte
Hieronymus	Rufname
Lehmayer	Beruf
Reitzler	Rufname
Baskurt	Kompositionelles Motiv
Grieble	Wohnstätte
Süßel	Übername
Namli	Rufnamenmuster
Lehmköster	Beruf
Jaworsky	Herkunft
Akdemir	Kompositionelles Motiv
Grönemann	Übername
Senay	Kompositionelles Motiv
Kocer	Kompositionelles Motiv
Lenkeit	Herkunft
Aktas	Kompositionelles Motiv
Grünrock	Übername
Mercanoglu	Rufnamenmuster
Goudschmidt	Beruf
Garber	Rufname
Kizilarslan	Kompositionelles Motiv
Olejnicki	Beruf
Bozdogan	Rufnamenmuster
Schroth	Übername
Bönhoff	Wohnstätte
Schleicherdt	Wohnstätte
Lefaivre	Beruf
Sensoy	Kompositionelles Motiv
Ceulen	Rufname
Cröger	Beruf
Boztas	Kompositionelles Motiv
Mett	Rufname
Karakulak	Rufnamenmuster
Scheiter	Beruf
Schleich	Wohnstätte
Ehrhorn	Herkunft
Ehrig	Herkunft
Curio	Beruf
Ackert	Beruf
Süssbier	Übername
Hilbers	Rufname
Tapp	Übername
Schröttle	Übername
Ohligschlaeger	Beruf
Reizer	Rufname
Bilir	Rufnamenmuster
Jürgenmeyer	Beruf
Aldemir	Kompositionelles Motiv
Holzweg	Wohnstätte
Karaarslan	Kompositionelles Motiv
Adibelli	Rufnamenmuster
Brodska	Herkunft
Süssmann	Übername
Büchele	Wohnstätte
Sevdi	Rufnamenmuster
Abts	Übername
Legler	Beruf
Acker	Wohnstätte
Leschzinski	Herkunft
Abdulla	Rufname
Grohnwald	Wohnstätte
Gaebelein	Rufname
Polatkan	Kompositionelles Motiv
Schliekermann	Wohnstätte
Brodsky	Herkunft
Thywißen	Rufname
Güloglu	Rufnamenmuster
Yavuzer	Kompositionelles Motiv
Taeuber	Übername
Ermis	Rufnamenmuster
Gontscharuk	Beruf
Jastczemski	Herkunft
Lütkemann	Übername
Gülsahin	Kompositionelles Motiv
Agirbas	Rufnamenmuster
Süsslin	Übername
Chlodwig	Rufname
Eichstätter	Herkunft
Cin	Rufnamenmuster
Jastrzebska	Herkunft
Akdere	Kompositionelles Motiv
Senpinar	Kompositionelles Motiv
Neuhs	Herkunft
Reitze	Rufname
Abramowsky	Herkunft
Reiss	Rufname
Thöl	Rufname
Gangl	Rufname
Süßlin	Übername
Schlehlein	Wohnstätte
Chalil	Rufname
Pussamsies	Übername
Baycan	Kompositionelles Motiv
Goosmann	Beruf
Lundström	Kompositionelles Motiv
Kocaman	Rufnamenmuster
Thönniß	Rufname
Gummersbach	Herkunft
Gahrmann	Rufname
Aytan	Kompositionelles Motiv
Abdulkader	Rufname
Agca	Übername
Akcay	Rufnamenmuster
Timphaus	Wohnstätte
Kubetschek	Rufname
Kayar	Rufnamenmuster
Lütkefedder	Übername
Reizner	Rufname
Choma	Rufname
Kaynak	Rufnamenmuster
Tazegül	Rufnamenmuster
Netzband	Herkunft
Akgül	Kompositionelles Motiv
Cihangir	Rufnamenmuster
Ayalp	Kompositionelles Motiv
Cakir	Rufnamenmuster
Neudecker	Herkunft
Metak	Rufname
Jedamsky	Herkunft
Talay	Rufnamenmuster
Tastan	Rufnamenmuster
Nordsieck	Wohnstätte
Reisslein	Rufname
Kücükakyüz	Kompositionelles Motiv
Metslaf	Rufname
Cigerli	Rufnamenmuster
Tombusch	Wohnstätte
Thöner	Rufname
Gencel	Kompositionelles Motiv
Honnacker	Wohnstätte
Klinghard	Übername
Scheib	Beruf
Putz	Übername
Uzunhan	Kompositionelles Motiv
Tomberger	Wohnstätte
Duda	Übername
Eibach	Herkunft
Camgöz	Rufnamenmuster
Kopmeyer	Beruf
Mart	Rufnamenmuster
Jungschaffer	Beruf
Göppinger	Herkunft
Kiziltoprak	Kompositionelles Motiv
Kiziltepe	Kompositionelles Motiv
Creutzmann	Beruf
Bösefeldt	Wohnstätte
Scheitterlein	Beruf
Kubicke	Rufname
Kuhljürgen	Wohnstätte
Abdelaziz	Rufname
Meves	Rufname
Neuendorf	Herkunft
Yigitsoy	Kompositionelles Motiv
Adenau	Herkunft
Kopfnagel	Beruf
Gürbüzer	Kompositionelles Motiv
Kruminsch	Wohnstätte
